,class,xmin,ymin,w,h,filename,width,height,xmax,ymax
0,text,369,85,164,40,0.png,1024,1448,533,125
1,text,200,134,532,26,0.png,1024,1448,732,160
2,text,639,239,132,20,0.png,1024,1448,771,259
3,text,639,257,252,20,0.png,1024,1448,891,277
4,text,637,277,166,20,0.png,1024,1448,803,297
5,text,641,297,108,18,0.png,1024,1448,749,315
6,text,379,391,156,44,0.png,1024,1448,535,435
7,text,33,465,42,20,0.png,1024,1448,75,485
8,text,64,516,109,21,0.png,1024,1448,173,537
9,text,180,516,74,24,0.png,1024,1448,254,540
10,text,313,517,50,20,0.png,1024,1448,363,537
11,text,389,517,70,20,0.png,1024,1448,459,537
12,text,529,515,50,20,0.png,1024,1448,579,535
13,text,721,515,120,20,0.png,1024,1448,841,535
14,text,863,513,70,20,0.png,1024,1448,933,533
15,text,53,575,78,20,0.png,1024,1448,131,595
16,text,297,575,92,20,0.png,1024,1448,389,595
17,text,577,573,32,18,0.png,1024,1448,609,591
18,text,647,577,82,16,0.png,1024,1448,729,593
19,text,749,577,56,16,0.png,1024,1448,805,593
20,text,839,575,86,18,0.png,1024,1448,925,593
21,text,34,610,105,16,0.png,1024,1448,139,626
22,text,159,610,202,16,0.png,1024,1448,361,626
23,text,666,609,73,18,0.png,1024,1448,739,627
24,text,869,609,64,18,0.png,1024,1448,933,627
25,text,35,626,102,17,0.png,1024,1448,137,643
26,text,159,626,192,17,0.png,1024,1448,351,643
27,text,681,627,58,15,0.png,1024,1448,739,642
28,text,883,627,52,18,0.png,1024,1448,935,645
29,text,129,1069,158,20,0.png,1024,1448,287,1089
30,text,737,1081,74,20,0.png,1024,1448,811,1101
31,text,870,1080,70,24,0.png,1024,1448,940,1104
32,text,181,1099,38,18,0.png,1024,1448,219,1117
33,text,157,1121,88,20,0.png,1024,1448,245,1141
34,text,737,1113,94,20,0.png,1024,1448,831,1133
35,text,882,1112,58,24,0.png,1024,1448,940,1136
36,text,177,1155,36,18,0.png,1024,1448,213,1173
37,text,263,1153,34,18,0.png,1024,1448,297,1171
38,text,736,1142,84,24,0.png,1024,1448,820,1166
39,text,867,1142,73,24,0.png,1024,1448,940,1166
40,text,23,1185,389,26,0.png,1024,1448,412,1211
41,text,25,1209,160,20,0.png,1024,1448,185,1229
42,text,347,1243,280,20,0.png,1024,1448,627,1263
43,text,127,1261,142,20,0.png,1024,1448,269,1281
44,text,278,1261,89,20,0.png,1024,1448,367,1281
45,text,381,1263,28,16,0.png,1024,1448,409,1279
46,text,415,1261,284,20,0.png,1024,1448,699,1281
47,text,707,1260,129,21,0.png,1024,1448,836,1281
48,text,161,1279,114,18,0.png,1024,1448,275,1297
49,text,301,1279,84,20,0.png,1024,1448,385,1299
50,text,407,1279,126,20,0.png,1024,1448,533,1299
51,text,713,1280,162,19,0.png,1024,1448,875,1299
52,text,593,609,14,17,0.png,1024,1448,607,626
53,text,593,627,15,16,0.png,1024,1448,608,643
54,text,78,638,0,1,0.png,1024,1448,78,639
55,text,555,1281,149,17,0.png,1024,1448,704,1298
56,text,369,85,164,40,0_contrasted.png,1024,1448,533,125
57,text,200,134,532,26,0_contrasted.png,1024,1448,732,160
58,text,639,239,132,20,0_contrasted.png,1024,1448,771,259
59,text,639,257,252,20,0_contrasted.png,1024,1448,891,277
60,text,637,277,166,20,0_contrasted.png,1024,1448,803,297
61,text,641,297,108,18,0_contrasted.png,1024,1448,749,315
62,text,379,391,156,44,0_contrasted.png,1024,1448,535,435
63,text,33,465,42,20,0_contrasted.png,1024,1448,75,485
64,text,64,516,109,21,0_contrasted.png,1024,1448,173,537
65,text,180,516,74,24,0_contrasted.png,1024,1448,254,540
66,text,313,517,50,20,0_contrasted.png,1024,1448,363,537
67,text,389,517,70,20,0_contrasted.png,1024,1448,459,537
68,text,529,515,50,20,0_contrasted.png,1024,1448,579,535
69,text,721,515,120,20,0_contrasted.png,1024,1448,841,535
70,text,863,513,70,20,0_contrasted.png,1024,1448,933,533
71,text,53,575,78,20,0_contrasted.png,1024,1448,131,595
72,text,297,575,92,20,0_contrasted.png,1024,1448,389,595
73,text,577,573,32,18,0_contrasted.png,1024,1448,609,591
74,text,647,577,82,16,0_contrasted.png,1024,1448,729,593
75,text,749,577,56,16,0_contrasted.png,1024,1448,805,593
76,text,839,575,86,18,0_contrasted.png,1024,1448,925,593
77,text,34,610,105,16,0_contrasted.png,1024,1448,139,626
78,text,159,610,202,16,0_contrasted.png,1024,1448,361,626
79,text,666,609,73,18,0_contrasted.png,1024,1448,739,627
80,text,869,609,64,18,0_contrasted.png,1024,1448,933,627
81,text,35,626,102,17,0_contrasted.png,1024,1448,137,643
82,text,159,626,192,17,0_contrasted.png,1024,1448,351,643
83,text,681,627,58,15,0_contrasted.png,1024,1448,739,642
84,text,883,627,52,18,0_contrasted.png,1024,1448,935,645
85,text,129,1069,158,20,0_contrasted.png,1024,1448,287,1089
86,text,737,1081,74,20,0_contrasted.png,1024,1448,811,1101
87,text,870,1080,70,24,0_contrasted.png,1024,1448,940,1104
88,text,181,1099,38,18,0_contrasted.png,1024,1448,219,1117
89,text,157,1121,88,20,0_contrasted.png,1024,1448,245,1141
90,text,737,1113,94,20,0_contrasted.png,1024,1448,831,1133
91,text,882,1112,58,24,0_contrasted.png,1024,1448,940,1136
92,text,177,1155,36,18,0_contrasted.png,1024,1448,213,1173
93,text,263,1153,34,18,0_contrasted.png,1024,1448,297,1171
94,text,736,1142,84,24,0_contrasted.png,1024,1448,820,1166
95,text,867,1142,73,24,0_contrasted.png,1024,1448,940,1166
96,text,23,1185,389,26,0_contrasted.png,1024,1448,412,1211
97,text,25,1209,160,20,0_contrasted.png,1024,1448,185,1229
98,text,347,1243,280,20,0_contrasted.png,1024,1448,627,1263
99,text,127,1261,142,20,0_contrasted.png,1024,1448,269,1281
100,text,278,1261,89,20,0_contrasted.png,1024,1448,367,1281
101,text,381,1263,28,16,0_contrasted.png,1024,1448,409,1279
102,text,415,1261,284,20,0_contrasted.png,1024,1448,699,1281
103,text,707,1260,129,21,0_contrasted.png,1024,1448,836,1281
104,text,161,1279,114,18,0_contrasted.png,1024,1448,275,1297
105,text,301,1279,84,20,0_contrasted.png,1024,1448,385,1299
106,text,407,1279,126,20,0_contrasted.png,1024,1448,533,1299
107,text,713,1280,162,19,0_contrasted.png,1024,1448,875,1299
108,text,593,609,14,17,0_contrasted.png,1024,1448,607,626
109,text,593,627,15,16,0_contrasted.png,1024,1448,608,643
110,text,78,638,0,1,0_contrasted.png,1024,1448,78,639
111,text,555,1281,149,17,0_contrasted.png,1024,1448,704,1298
112,text,369,85,164,40,0_denoise.png,1024,1448,533,125
113,text,200,134,532,26,0_denoise.png,1024,1448,732,160
114,text,639,239,132,20,0_denoise.png,1024,1448,771,259
115,text,639,257,252,20,0_denoise.png,1024,1448,891,277
116,text,637,277,166,20,0_denoise.png,1024,1448,803,297
117,text,641,297,108,18,0_denoise.png,1024,1448,749,315
118,text,379,391,156,44,0_denoise.png,1024,1448,535,435
119,text,33,465,42,20,0_denoise.png,1024,1448,75,485
120,text,64,516,109,21,0_denoise.png,1024,1448,173,537
121,text,180,516,74,24,0_denoise.png,1024,1448,254,540
122,text,313,517,50,20,0_denoise.png,1024,1448,363,537
123,text,389,517,70,20,0_denoise.png,1024,1448,459,537
124,text,529,515,50,20,0_denoise.png,1024,1448,579,535
125,text,721,515,120,20,0_denoise.png,1024,1448,841,535
126,text,863,513,70,20,0_denoise.png,1024,1448,933,533
127,text,53,575,78,20,0_denoise.png,1024,1448,131,595
128,text,297,575,92,20,0_denoise.png,1024,1448,389,595
129,text,577,573,32,18,0_denoise.png,1024,1448,609,591
130,text,647,577,82,16,0_denoise.png,1024,1448,729,593
131,text,749,577,56,16,0_denoise.png,1024,1448,805,593
132,text,839,575,86,18,0_denoise.png,1024,1448,925,593
133,text,34,610,105,16,0_denoise.png,1024,1448,139,626
134,text,159,610,202,16,0_denoise.png,1024,1448,361,626
135,text,666,609,73,18,0_denoise.png,1024,1448,739,627
136,text,869,609,64,18,0_denoise.png,1024,1448,933,627
137,text,35,626,102,17,0_denoise.png,1024,1448,137,643
138,text,159,626,192,17,0_denoise.png,1024,1448,351,643
139,text,681,627,58,15,0_denoise.png,1024,1448,739,642
140,text,883,627,52,18,0_denoise.png,1024,1448,935,645
141,text,129,1069,158,20,0_denoise.png,1024,1448,287,1089
142,text,737,1081,74,20,0_denoise.png,1024,1448,811,1101
143,text,870,1080,70,24,0_denoise.png,1024,1448,940,1104
144,text,181,1099,38,18,0_denoise.png,1024,1448,219,1117
145,text,157,1121,88,20,0_denoise.png,1024,1448,245,1141
146,text,737,1113,94,20,0_denoise.png,1024,1448,831,1133
147,text,882,1112,58,24,0_denoise.png,1024,1448,940,1136
148,text,177,1155,36,18,0_denoise.png,1024,1448,213,1173
149,text,263,1153,34,18,0_denoise.png,1024,1448,297,1171
150,text,736,1142,84,24,0_denoise.png,1024,1448,820,1166
151,text,867,1142,73,24,0_denoise.png,1024,1448,940,1166
152,text,23,1185,389,26,0_denoise.png,1024,1448,412,1211
153,text,25,1209,160,20,0_denoise.png,1024,1448,185,1229
154,text,347,1243,280,20,0_denoise.png,1024,1448,627,1263
155,text,127,1261,142,20,0_denoise.png,1024,1448,269,1281
156,text,278,1261,89,20,0_denoise.png,1024,1448,367,1281
157,text,381,1263,28,16,0_denoise.png,1024,1448,409,1279
158,text,415,1261,284,20,0_denoise.png,1024,1448,699,1281
159,text,707,1260,129,21,0_denoise.png,1024,1448,836,1281
160,text,161,1279,114,18,0_denoise.png,1024,1448,275,1297
161,text,301,1279,84,20,0_denoise.png,1024,1448,385,1299
162,text,407,1279,126,20,0_denoise.png,1024,1448,533,1299
163,text,713,1280,162,19,0_denoise.png,1024,1448,875,1299
164,text,593,609,14,17,0_denoise.png,1024,1448,607,626
165,text,593,627,15,16,0_denoise.png,1024,1448,608,643
166,text,78,638,0,1,0_denoise.png,1024,1448,78,639
167,text,555,1281,149,17,0_denoise.png,1024,1448,704,1298
168,text,369,85,164,40,0_median.png,1024,1448,533,125
169,text,200,134,532,26,0_median.png,1024,1448,732,160
170,text,639,239,132,20,0_median.png,1024,1448,771,259
171,text,639,257,252,20,0_median.png,1024,1448,891,277
172,text,637,277,166,20,0_median.png,1024,1448,803,297
173,text,641,297,108,18,0_median.png,1024,1448,749,315
174,text,379,391,156,44,0_median.png,1024,1448,535,435
175,text,33,465,42,20,0_median.png,1024,1448,75,485
176,text,64,516,109,21,0_median.png,1024,1448,173,537
177,text,180,516,74,24,0_median.png,1024,1448,254,540
178,text,313,517,50,20,0_median.png,1024,1448,363,537
179,text,389,517,70,20,0_median.png,1024,1448,459,537
180,text,529,515,50,20,0_median.png,1024,1448,579,535
181,text,721,515,120,20,0_median.png,1024,1448,841,535
182,text,863,513,70,20,0_median.png,1024,1448,933,533
183,text,53,575,78,20,0_median.png,1024,1448,131,595
184,text,297,575,92,20,0_median.png,1024,1448,389,595
185,text,577,573,32,18,0_median.png,1024,1448,609,591
186,text,647,577,82,16,0_median.png,1024,1448,729,593
187,text,749,577,56,16,0_median.png,1024,1448,805,593
188,text,839,575,86,18,0_median.png,1024,1448,925,593
189,text,34,610,105,16,0_median.png,1024,1448,139,626
190,text,159,610,202,16,0_median.png,1024,1448,361,626
191,text,666,609,73,18,0_median.png,1024,1448,739,627
192,text,869,609,64,18,0_median.png,1024,1448,933,627
193,text,35,626,102,17,0_median.png,1024,1448,137,643
194,text,159,626,192,17,0_median.png,1024,1448,351,643
195,text,681,627,58,15,0_median.png,1024,1448,739,642
196,text,883,627,52,18,0_median.png,1024,1448,935,645
197,text,129,1069,158,20,0_median.png,1024,1448,287,1089
198,text,737,1081,74,20,0_median.png,1024,1448,811,1101
199,text,870,1080,70,24,0_median.png,1024,1448,940,1104
200,text,181,1099,38,18,0_median.png,1024,1448,219,1117
201,text,157,1121,88,20,0_median.png,1024,1448,245,1141
202,text,737,1113,94,20,0_median.png,1024,1448,831,1133
203,text,882,1112,58,24,0_median.png,1024,1448,940,1136
204,text,177,1155,36,18,0_median.png,1024,1448,213,1173
205,text,263,1153,34,18,0_median.png,1024,1448,297,1171
206,text,736,1142,84,24,0_median.png,1024,1448,820,1166
207,text,867,1142,73,24,0_median.png,1024,1448,940,1166
208,text,23,1185,389,26,0_median.png,1024,1448,412,1211
209,text,25,1209,160,20,0_median.png,1024,1448,185,1229
210,text,347,1243,280,20,0_median.png,1024,1448,627,1263
211,text,127,1261,142,20,0_median.png,1024,1448,269,1281
212,text,278,1261,89,20,0_median.png,1024,1448,367,1281
213,text,381,1263,28,16,0_median.png,1024,1448,409,1279
214,text,415,1261,284,20,0_median.png,1024,1448,699,1281
215,text,707,1260,129,21,0_median.png,1024,1448,836,1281
216,text,161,1279,114,18,0_median.png,1024,1448,275,1297
217,text,301,1279,84,20,0_median.png,1024,1448,385,1299
218,text,407,1279,126,20,0_median.png,1024,1448,533,1299
219,text,713,1280,162,19,0_median.png,1024,1448,875,1299
220,text,593,609,14,17,0_median.png,1024,1448,607,626
221,text,593,627,15,16,0_median.png,1024,1448,608,643
222,text,78,638,0,1,0_median.png,1024,1448,78,639
223,text,555,1281,149,17,0_median.png,1024,1448,704,1298
224,text,374,76,362,32,1.png,1024,1448,736,108
225,text,442,112,229,30,1.png,1024,1448,671,142
226,text,386,144,90,26,1.png,1024,1448,476,170
227,text,492,144,231,26,1.png,1024,1448,723,170
228,text,138,204,80,28,1.png,1024,1448,218,232
229,text,239,200,318,37,1.png,1024,1448,557,237
230,text,676,213,168,27,1.png,1024,1448,844,240
231,text,136,260,230,24,1.png,1024,1448,366,284
232,text,678,296,252,26,1.png,1024,1448,930,322
233,text,138,312,106,26,1.png,1024,1448,244,338
234,text,135,338,357,28,1.png,1024,1448,492,366
235,text,137,362,65,27,1.png,1024,1448,202,389
236,text,180,438,216,26,1.png,1024,1448,396,464
237,text,412,438,424,28,1.png,1024,1448,836,466
238,text,180,526,230,28,1.png,1024,1448,410,554
239,text,856,528,112,26,1.png,1024,1448,968,554
240,text,180,556,164,30,1.png,1024,1448,344,586
241,text,870,556,96,26,1.png,1024,1448,966,582
242,text,178,584,162,26,1.png,1024,1448,340,610
243,text,856,584,110,28,1.png,1024,1448,966,612
244,text,126,660,780,32,1.png,1024,1448,906,692
245,text,124,694,230,30,1.png,1024,1448,354,724
246,text,178,1209,664,27,1.png,1024,1448,842,1236
247,text,228,1237,226,23,1.png,1024,1448,454,1260
248,text,468,1238,319,25,1.png,1024,1448,787,1263
249,text,104,1265,202,22,1.png,1024,1448,306,1287
250,text,738,1263,176,24,1.png,1024,1448,914,1287
251,text,198,1288,614,28,1.png,1024,1448,812,1316
252,text,294,1320,426,22,1.png,1024,1448,720,1342
253,text,313,1263,253,24,1.png,1024,1448,566,1287
254,text,575,1263,148,24,1.png,1024,1448,723,1287
255,text,52,58,228,50,10.png,1024,1448,280,108
256,text,122,174,142,26,10.png,1024,1448,264,200
257,text,279,174,132,25,10.png,1024,1448,411,199
258,text,555,177,114,20,10.png,1024,1448,669,197
259,text,554,214,342,17,10.png,1024,1448,896,231
260,text,554,232,364,19,10.png,1024,1448,918,251
261,text,555,251,106,18,10.png,1024,1448,661,269
262,text,673,250,62,20,10.png,1024,1448,735,270
263,text,553,270,138,17,10.png,1024,1448,691,287
264,text,557,293,181,17,10.png,1024,1448,738,310
265,text,699,322,241,26,10.png,1024,1448,940,348
266,text,34,346,107,29,10.png,1024,1448,141,375
267,text,177,351,70,20,10.png,1024,1448,247,371
268,text,79,403,106,20,10.png,1024,1448,185,423
269,text,354,402,108,24,10.png,1024,1448,462,426
270,text,596,400,38,24,10.png,1024,1448,634,424
271,text,679,401,34,20,10.png,1024,1448,713,421
272,text,813,399,78,20,10.png,1024,1448,891,419
273,text,267,433,148,20,10.png,1024,1448,415,453
274,text,420,431,128,20,10.png,1024,1448,548,451
275,text,27,459,66,20,10.png,1024,1448,93,479
276,text,234,456,286,24,10.png,1024,1448,520,480
277,text,591,457,38,20,10.png,1024,1448,629,477
278,text,673,455,58,20,10.png,1024,1448,731,475
279,text,819,453,60,20,10.png,1024,1448,879,473
280,text,236,478,188,24,10.png,1024,1448,424,502
281,text,55,505,114,20,10.png,1024,1448,169,525
282,text,234,501,284,27,10.png,1024,1448,518,528
283,text,523,507,32,16,10.png,1024,1448,555,523
284,text,591,503,38,20,10.png,1024,1448,629,523
285,text,671,503,60,20,10.png,1024,1448,731,523
286,text,819,501,58,20,10.png,1024,1448,877,521
287,text,46,1046,72,24,10.png,1024,1448,118,1070
288,text,143,1047,26,20,10.png,1024,1448,169,1067
289,text,205,1047,70,20,10.png,1024,1448,275,1067
290,text,619,1041,100,20,10.png,1024,1448,719,1061
291,text,800,1038,72,25,10.png,1024,1448,872,1063
292,text,609,1071,112,20,10.png,1024,1448,721,1091
293,text,800,1068,72,24,10.png,1024,1448,872,1092
294,text,613,1101,110,20,10.png,1024,1448,723,1121
295,text,800,1098,72,24,10.png,1024,1448,872,1122
296,text,26,1138,372,26,10.png,1024,1448,398,1164
297,text,500,1134,190,26,10.png,1024,1448,690,1160
298,text,34,1170,246,24,10.png,1024,1448,280,1194
299,text,500,1160,322,24,10.png,1024,1448,822,1184
300,text,16,1319,360,20,10.png,1024,1448,376,1339
301,text,651,1315,104,20,10.png,1024,1448,755,1335
302,text,767,1315,140,20,10.png,1024,1448,907,1335
303,text,97,1339,118,18,10.png,1024,1448,215,1357
304,text,221,1337,144,20,10.png,1024,1448,365,1357
305,text,371,1337,102,20,10.png,1024,1448,473,1357
306,text,479,1337,138,18,10.png,1024,1448,617,1355
307,text,624,1335,204,18,10.png,1024,1448,828,1353
308,text,356,1356,220,21,10.png,1024,1448,576,1377
309,text,388,1318,106,20,10.png,1024,1448,494,1338
310,text,498,1319,140,16,10.png,1024,1448,638,1335
311,text,398,116,364,50,100.png,1024,1430,762,166
312,text,205,166,759,66,100.png,1024,1430,964,232
313,text,27,245,72,16,100.png,1024,1430,99,261
314,text,201,244,144,18,100.png,1024,1430,345,262
315,text,392,244,121,18,100.png,1024,1430,513,262
316,text,649,245,82,16,100.png,1024,1430,731,261
317,text,819,245,164,16,100.png,1024,1430,983,261
318,text,25,261,48,14,100.png,1024,1430,73,275
319,text,81,261,64,14,100.png,1024,1430,145,275
320,text,201,261,174,14,100.png,1024,1430,375,275
321,text,395,261,142,14,100.png,1024,1430,537,275
322,text,651,261,140,16,100.png,1024,1430,791,277
323,text,817,261,122,16,100.png,1024,1430,939,277
324,text,27,275,44,16,100.png,1024,1430,71,291
325,text,79,275,100,16,100.png,1024,1430,179,291
326,text,200,274,47,20,100.png,1024,1430,247,294
327,text,393,277,238,14,100.png,1024,1430,631,291
328,text,651,276,147,15,100.png,1024,1430,798,291
329,text,819,277,94,14,100.png,1024,1430,913,291
330,text,27,291,50,14,100.png,1024,1430,77,305
331,text,199,290,122,16,100.png,1024,1430,321,306
332,text,395,291,140,16,100.png,1024,1430,535,307
333,text,649,291,92,16,100.png,1024,1430,741,307
334,text,817,291,144,16,100.png,1024,1430,961,307
335,text,25,307,54,14,100.png,1024,1430,79,321
336,text,87,305,84,16,100.png,1024,1430,171,321
337,text,199,307,168,16,100.png,1024,1430,367,323
338,text,393,307,230,16,100.png,1024,1430,623,323
339,text,649,307,90,14,100.png,1024,1430,739,321
340,text,817,307,154,14,100.png,1024,1430,971,321
341,text,25,321,52,16,100.png,1024,1430,77,337
342,text,85,321,90,16,100.png,1024,1430,175,337
343,text,199,321,138,16,100.png,1024,1430,337,337
344,text,393,321,48,16,100.png,1024,1430,441,337
345,text,649,321,96,16,100.png,1024,1430,745,337
346,text,817,321,60,16,100.png,1024,1430,877,337
347,text,38,346,146,32,100.png,1024,1430,184,378
348,text,270,352,322,24,100.png,1024,1430,592,376
349,text,699,375,104,20,100.png,1024,1430,803,395
350,text,37,414,113,19,100.png,1024,1430,150,433
351,text,355,417,34,16,100.png,1024,1430,389,433
352,text,413,415,154,18,100.png,1024,1430,567,433
353,text,37,435,114,18,100.png,1024,1430,151,453
354,text,696,434,106,21,100.png,1024,1430,802,455
355,text,34,455,171,22,100.png,1024,1430,205,477
356,text,655,455,189,20,100.png,1024,1430,844,475
357,text,52,524,64,28,100.png,1024,1430,116,552
358,text,148,524,60,28,100.png,1024,1430,208,552
359,text,246,526,82,26,100.png,1024,1430,328,552
360,text,428,525,113,29,100.png,1024,1430,541,554
361,text,640,529,68,25,100.png,1024,1430,708,554
362,text,736,528,58,25,100.png,1024,1430,794,553
363,text,861,534,85,19,100.png,1024,1430,946,553
364,text,233,561,52,14,100.png,1024,1430,285,575
365,text,359,559,257,16,100.png,1024,1430,616,575
366,text,673,559,38,16,100.png,1024,1430,711,575
367,text,759,561,36,14,100.png,1024,1430,795,575
368,text,359,575,58,16,100.png,1024,1430,417,591
369,text,60,1154,94,24,100.png,1024,1430,154,1178
370,text,261,1149,58,20,100.png,1024,1430,319,1169
371,text,386,1154,48,24,100.png,1024,1430,434,1178
372,text,549,1149,46,18,100.png,1024,1430,595,1167
373,text,601,1151,37,16,100.png,1024,1430,638,1167
374,text,670,1154,60,24,100.png,1024,1430,730,1178
375,text,347,1255,133,18,100.png,1024,1430,480,1273
376,text,49,1277,42,16,100.png,1024,1430,91,1293
377,text,99,1279,42,14,100.png,1024,1430,141,1293
378,text,147,1277,245,17,100.png,1024,1430,392,1294
379,text,841,1278,82,20,100.png,1024,1430,923,1298
380,text,49,1297,172,18,100.png,1024,1430,221,1315
381,text,227,1297,84,16,100.png,1024,1430,311,1313
382,text,13,1347,270,20,100.png,1024,1430,283,1367
383,text,291,1349,82,18,100.png,1024,1430,373,1367
384,text,381,1347,410,20,100.png,1024,1430,791,1367
385,text,799,1347,138,20,100.png,1024,1430,937,1367
386,text,28,1367,208,22,100.png,1024,1430,236,1389
387,text,243,1367,97,20,100.png,1024,1430,340,1387
388,text,349,1367,147,20,100.png,1024,1430,496,1387
389,text,505,1367,95,20,100.png,1024,1430,600,1387
390,text,609,1367,130,20,100.png,1024,1430,739,1387
391,text,812,530,43,24,100.png,1024,1430,855,554
392,text,827,559,20,14,100.png,1024,1430,847,573
393,text,900,558,47,16,100.png,1024,1430,947,574
394,text,744,1154,46,26,100.png,1024,1430,790,1180
395,text,881,1150,64,19,100.png,1024,1430,945,1169
396,text,137,1200,39,17,100.png,1024,1430,176,1217
397,text,52,1197,77,22,100.png,1024,1430,129,1219
398,text,39,1254,300,18,100.png,1024,1430,339,1272
399,text,750,1368,169,20,100.png,1024,1430,919,1388
400,text,398,116,364,50,100_contrasted.png,1024,1430,762,166
401,text,205,166,759,66,100_contrasted.png,1024,1430,964,232
402,text,27,245,72,16,100_contrasted.png,1024,1430,99,261
403,text,201,244,144,18,100_contrasted.png,1024,1430,345,262
404,text,392,244,121,18,100_contrasted.png,1024,1430,513,262
405,text,649,245,82,16,100_contrasted.png,1024,1430,731,261
406,text,819,245,164,16,100_contrasted.png,1024,1430,983,261
407,text,25,261,48,14,100_contrasted.png,1024,1430,73,275
408,text,81,261,64,14,100_contrasted.png,1024,1430,145,275
409,text,201,261,174,14,100_contrasted.png,1024,1430,375,275
410,text,395,261,142,14,100_contrasted.png,1024,1430,537,275
411,text,651,261,140,16,100_contrasted.png,1024,1430,791,277
412,text,817,261,122,16,100_contrasted.png,1024,1430,939,277
413,text,27,275,44,16,100_contrasted.png,1024,1430,71,291
414,text,79,275,100,16,100_contrasted.png,1024,1430,179,291
415,text,200,274,47,20,100_contrasted.png,1024,1430,247,294
416,text,393,277,238,14,100_contrasted.png,1024,1430,631,291
417,text,651,276,147,15,100_contrasted.png,1024,1430,798,291
418,text,819,277,94,14,100_contrasted.png,1024,1430,913,291
419,text,27,291,50,14,100_contrasted.png,1024,1430,77,305
420,text,199,290,122,16,100_contrasted.png,1024,1430,321,306
421,text,395,291,140,16,100_contrasted.png,1024,1430,535,307
422,text,649,291,92,16,100_contrasted.png,1024,1430,741,307
423,text,817,291,144,16,100_contrasted.png,1024,1430,961,307
424,text,25,307,54,14,100_contrasted.png,1024,1430,79,321
425,text,87,305,84,16,100_contrasted.png,1024,1430,171,321
426,text,199,307,168,16,100_contrasted.png,1024,1430,367,323
427,text,393,307,230,16,100_contrasted.png,1024,1430,623,323
428,text,649,307,90,14,100_contrasted.png,1024,1430,739,321
429,text,817,307,154,14,100_contrasted.png,1024,1430,971,321
430,text,25,321,52,16,100_contrasted.png,1024,1430,77,337
431,text,85,321,90,16,100_contrasted.png,1024,1430,175,337
432,text,199,321,138,16,100_contrasted.png,1024,1430,337,337
433,text,393,321,48,16,100_contrasted.png,1024,1430,441,337
434,text,649,321,96,16,100_contrasted.png,1024,1430,745,337
435,text,817,321,60,16,100_contrasted.png,1024,1430,877,337
436,text,38,346,146,32,100_contrasted.png,1024,1430,184,378
437,text,270,352,322,24,100_contrasted.png,1024,1430,592,376
438,text,699,375,104,20,100_contrasted.png,1024,1430,803,395
439,text,37,414,113,19,100_contrasted.png,1024,1430,150,433
440,text,355,417,34,16,100_contrasted.png,1024,1430,389,433
441,text,413,415,154,18,100_contrasted.png,1024,1430,567,433
442,text,37,435,114,18,100_contrasted.png,1024,1430,151,453
443,text,696,434,106,21,100_contrasted.png,1024,1430,802,455
444,text,34,455,171,22,100_contrasted.png,1024,1430,205,477
445,text,655,455,189,20,100_contrasted.png,1024,1430,844,475
446,text,52,524,64,28,100_contrasted.png,1024,1430,116,552
447,text,148,524,60,28,100_contrasted.png,1024,1430,208,552
448,text,246,526,82,26,100_contrasted.png,1024,1430,328,552
449,text,428,525,113,29,100_contrasted.png,1024,1430,541,554
450,text,640,529,68,25,100_contrasted.png,1024,1430,708,554
451,text,736,528,58,25,100_contrasted.png,1024,1430,794,553
452,text,861,534,85,19,100_contrasted.png,1024,1430,946,553
453,text,233,561,52,14,100_contrasted.png,1024,1430,285,575
454,text,359,559,257,16,100_contrasted.png,1024,1430,616,575
455,text,673,559,38,16,100_contrasted.png,1024,1430,711,575
456,text,759,561,36,14,100_contrasted.png,1024,1430,795,575
457,text,359,575,58,16,100_contrasted.png,1024,1430,417,591
458,text,60,1154,94,24,100_contrasted.png,1024,1430,154,1178
459,text,261,1149,58,20,100_contrasted.png,1024,1430,319,1169
460,text,386,1154,48,24,100_contrasted.png,1024,1430,434,1178
461,text,549,1149,46,18,100_contrasted.png,1024,1430,595,1167
462,text,601,1151,37,16,100_contrasted.png,1024,1430,638,1167
463,text,670,1154,60,24,100_contrasted.png,1024,1430,730,1178
464,text,347,1255,133,18,100_contrasted.png,1024,1430,480,1273
465,text,49,1277,42,16,100_contrasted.png,1024,1430,91,1293
466,text,99,1279,42,14,100_contrasted.png,1024,1430,141,1293
467,text,147,1277,245,17,100_contrasted.png,1024,1430,392,1294
468,text,841,1278,82,20,100_contrasted.png,1024,1430,923,1298
469,text,49,1297,172,18,100_contrasted.png,1024,1430,221,1315
470,text,227,1297,84,16,100_contrasted.png,1024,1430,311,1313
471,text,13,1347,270,20,100_contrasted.png,1024,1430,283,1367
472,text,291,1349,82,18,100_contrasted.png,1024,1430,373,1367
473,text,381,1347,410,20,100_contrasted.png,1024,1430,791,1367
474,text,799,1347,138,20,100_contrasted.png,1024,1430,937,1367
475,text,28,1367,208,22,100_contrasted.png,1024,1430,236,1389
476,text,243,1367,97,20,100_contrasted.png,1024,1430,340,1387
477,text,349,1367,147,20,100_contrasted.png,1024,1430,496,1387
478,text,505,1367,95,20,100_contrasted.png,1024,1430,600,1387
479,text,609,1367,130,20,100_contrasted.png,1024,1430,739,1387
480,text,812,530,43,24,100_contrasted.png,1024,1430,855,554
481,text,827,559,20,14,100_contrasted.png,1024,1430,847,573
482,text,900,558,47,16,100_contrasted.png,1024,1430,947,574
483,text,744,1154,46,26,100_contrasted.png,1024,1430,790,1180
484,text,881,1150,64,19,100_contrasted.png,1024,1430,945,1169
485,text,137,1200,39,17,100_contrasted.png,1024,1430,176,1217
486,text,52,1197,77,22,100_contrasted.png,1024,1430,129,1219
487,text,39,1254,300,18,100_contrasted.png,1024,1430,339,1272
488,text,750,1368,169,20,100_contrasted.png,1024,1430,919,1388
489,text,398,116,364,50,100_denoise.png,1024,1430,762,166
490,text,205,166,759,66,100_denoise.png,1024,1430,964,232
491,text,27,245,72,16,100_denoise.png,1024,1430,99,261
492,text,201,244,144,18,100_denoise.png,1024,1430,345,262
493,text,392,244,121,18,100_denoise.png,1024,1430,513,262
494,text,649,245,82,16,100_denoise.png,1024,1430,731,261
495,text,819,245,164,16,100_denoise.png,1024,1430,983,261
496,text,25,261,48,14,100_denoise.png,1024,1430,73,275
497,text,81,261,64,14,100_denoise.png,1024,1430,145,275
498,text,201,261,174,14,100_denoise.png,1024,1430,375,275
499,text,395,261,142,14,100_denoise.png,1024,1430,537,275
500,text,651,261,140,16,100_denoise.png,1024,1430,791,277
501,text,817,261,122,16,100_denoise.png,1024,1430,939,277
502,text,27,275,44,16,100_denoise.png,1024,1430,71,291
503,text,79,275,100,16,100_denoise.png,1024,1430,179,291
504,text,200,274,47,20,100_denoise.png,1024,1430,247,294
505,text,393,277,238,14,100_denoise.png,1024,1430,631,291
506,text,651,276,147,15,100_denoise.png,1024,1430,798,291
507,text,819,277,94,14,100_denoise.png,1024,1430,913,291
508,text,27,291,50,14,100_denoise.png,1024,1430,77,305
509,text,199,290,122,16,100_denoise.png,1024,1430,321,306
510,text,395,291,140,16,100_denoise.png,1024,1430,535,307
511,text,649,291,92,16,100_denoise.png,1024,1430,741,307
512,text,817,291,144,16,100_denoise.png,1024,1430,961,307
513,text,25,307,54,14,100_denoise.png,1024,1430,79,321
514,text,87,305,84,16,100_denoise.png,1024,1430,171,321
515,text,199,307,168,16,100_denoise.png,1024,1430,367,323
516,text,393,307,230,16,100_denoise.png,1024,1430,623,323
517,text,649,307,90,14,100_denoise.png,1024,1430,739,321
518,text,817,307,154,14,100_denoise.png,1024,1430,971,321
519,text,25,321,52,16,100_denoise.png,1024,1430,77,337
520,text,85,321,90,16,100_denoise.png,1024,1430,175,337
521,text,199,321,138,16,100_denoise.png,1024,1430,337,337
522,text,393,321,48,16,100_denoise.png,1024,1430,441,337
523,text,649,321,96,16,100_denoise.png,1024,1430,745,337
524,text,817,321,60,16,100_denoise.png,1024,1430,877,337
525,text,38,346,146,32,100_denoise.png,1024,1430,184,378
526,text,270,352,322,24,100_denoise.png,1024,1430,592,376
527,text,699,375,104,20,100_denoise.png,1024,1430,803,395
528,text,37,414,113,19,100_denoise.png,1024,1430,150,433
529,text,355,417,34,16,100_denoise.png,1024,1430,389,433
530,text,413,415,154,18,100_denoise.png,1024,1430,567,433
531,text,37,435,114,18,100_denoise.png,1024,1430,151,453
532,text,696,434,106,21,100_denoise.png,1024,1430,802,455
533,text,34,455,171,22,100_denoise.png,1024,1430,205,477
534,text,655,455,189,20,100_denoise.png,1024,1430,844,475
535,text,52,524,64,28,100_denoise.png,1024,1430,116,552
536,text,148,524,60,28,100_denoise.png,1024,1430,208,552
537,text,246,526,82,26,100_denoise.png,1024,1430,328,552
538,text,428,525,113,29,100_denoise.png,1024,1430,541,554
539,text,640,529,68,25,100_denoise.png,1024,1430,708,554
540,text,736,528,58,25,100_denoise.png,1024,1430,794,553
541,text,861,534,85,19,100_denoise.png,1024,1430,946,553
542,text,233,561,52,14,100_denoise.png,1024,1430,285,575
543,text,359,559,257,16,100_denoise.png,1024,1430,616,575
544,text,673,559,38,16,100_denoise.png,1024,1430,711,575
545,text,759,561,36,14,100_denoise.png,1024,1430,795,575
546,text,359,575,58,16,100_denoise.png,1024,1430,417,591
547,text,60,1154,94,24,100_denoise.png,1024,1430,154,1178
548,text,261,1149,58,20,100_denoise.png,1024,1430,319,1169
549,text,386,1154,48,24,100_denoise.png,1024,1430,434,1178
550,text,549,1149,46,18,100_denoise.png,1024,1430,595,1167
551,text,601,1151,37,16,100_denoise.png,1024,1430,638,1167
552,text,670,1154,60,24,100_denoise.png,1024,1430,730,1178
553,text,347,1255,133,18,100_denoise.png,1024,1430,480,1273
554,text,49,1277,42,16,100_denoise.png,1024,1430,91,1293
555,text,99,1279,42,14,100_denoise.png,1024,1430,141,1293
556,text,147,1277,245,17,100_denoise.png,1024,1430,392,1294
557,text,841,1278,82,20,100_denoise.png,1024,1430,923,1298
558,text,49,1297,172,18,100_denoise.png,1024,1430,221,1315
559,text,227,1297,84,16,100_denoise.png,1024,1430,311,1313
560,text,13,1347,270,20,100_denoise.png,1024,1430,283,1367
561,text,291,1349,82,18,100_denoise.png,1024,1430,373,1367
562,text,381,1347,410,20,100_denoise.png,1024,1430,791,1367
563,text,799,1347,138,20,100_denoise.png,1024,1430,937,1367
564,text,28,1367,208,22,100_denoise.png,1024,1430,236,1389
565,text,243,1367,97,20,100_denoise.png,1024,1430,340,1387
566,text,349,1367,147,20,100_denoise.png,1024,1430,496,1387
567,text,505,1367,95,20,100_denoise.png,1024,1430,600,1387
568,text,609,1367,130,20,100_denoise.png,1024,1430,739,1387
569,text,812,530,43,24,100_denoise.png,1024,1430,855,554
570,text,827,559,20,14,100_denoise.png,1024,1430,847,573
571,text,900,558,47,16,100_denoise.png,1024,1430,947,574
572,text,744,1154,46,26,100_denoise.png,1024,1430,790,1180
573,text,881,1150,64,19,100_denoise.png,1024,1430,945,1169
574,text,137,1200,39,17,100_denoise.png,1024,1430,176,1217
575,text,52,1197,77,22,100_denoise.png,1024,1430,129,1219
576,text,39,1254,300,18,100_denoise.png,1024,1430,339,1272
577,text,750,1368,169,20,100_denoise.png,1024,1430,919,1388
578,text,398,116,364,50,100_median.png,1024,1430,762,166
579,text,205,166,759,66,100_median.png,1024,1430,964,232
580,text,27,245,72,16,100_median.png,1024,1430,99,261
581,text,201,244,144,18,100_median.png,1024,1430,345,262
582,text,392,244,121,18,100_median.png,1024,1430,513,262
583,text,649,245,82,16,100_median.png,1024,1430,731,261
584,text,819,245,164,16,100_median.png,1024,1430,983,261
585,text,25,261,48,14,100_median.png,1024,1430,73,275
586,text,81,261,64,14,100_median.png,1024,1430,145,275
587,text,201,261,174,14,100_median.png,1024,1430,375,275
588,text,395,261,142,14,100_median.png,1024,1430,537,275
589,text,651,261,140,16,100_median.png,1024,1430,791,277
590,text,817,261,122,16,100_median.png,1024,1430,939,277
591,text,27,275,44,16,100_median.png,1024,1430,71,291
592,text,79,275,100,16,100_median.png,1024,1430,179,291
593,text,200,274,47,20,100_median.png,1024,1430,247,294
594,text,393,277,238,14,100_median.png,1024,1430,631,291
595,text,651,276,147,15,100_median.png,1024,1430,798,291
596,text,819,277,94,14,100_median.png,1024,1430,913,291
597,text,27,291,50,14,100_median.png,1024,1430,77,305
598,text,199,290,122,16,100_median.png,1024,1430,321,306
599,text,395,291,140,16,100_median.png,1024,1430,535,307
600,text,649,291,92,16,100_median.png,1024,1430,741,307
601,text,817,291,144,16,100_median.png,1024,1430,961,307
602,text,25,307,54,14,100_median.png,1024,1430,79,321
603,text,87,305,84,16,100_median.png,1024,1430,171,321
604,text,199,307,168,16,100_median.png,1024,1430,367,323
605,text,393,307,230,16,100_median.png,1024,1430,623,323
606,text,649,307,90,14,100_median.png,1024,1430,739,321
607,text,817,307,154,14,100_median.png,1024,1430,971,321
608,text,25,321,52,16,100_median.png,1024,1430,77,337
609,text,85,321,90,16,100_median.png,1024,1430,175,337
610,text,199,321,138,16,100_median.png,1024,1430,337,337
611,text,393,321,48,16,100_median.png,1024,1430,441,337
612,text,649,321,96,16,100_median.png,1024,1430,745,337
613,text,817,321,60,16,100_median.png,1024,1430,877,337
614,text,38,346,146,32,100_median.png,1024,1430,184,378
615,text,270,352,322,24,100_median.png,1024,1430,592,376
616,text,699,375,104,20,100_median.png,1024,1430,803,395
617,text,37,414,113,19,100_median.png,1024,1430,150,433
618,text,355,417,34,16,100_median.png,1024,1430,389,433
619,text,413,415,154,18,100_median.png,1024,1430,567,433
620,text,37,435,114,18,100_median.png,1024,1430,151,453
621,text,696,434,106,21,100_median.png,1024,1430,802,455
622,text,34,455,171,22,100_median.png,1024,1430,205,477
623,text,655,455,189,20,100_median.png,1024,1430,844,475
624,text,52,524,64,28,100_median.png,1024,1430,116,552
625,text,148,524,60,28,100_median.png,1024,1430,208,552
626,text,246,526,82,26,100_median.png,1024,1430,328,552
627,text,428,525,113,29,100_median.png,1024,1430,541,554
628,text,640,529,68,25,100_median.png,1024,1430,708,554
629,text,736,528,58,25,100_median.png,1024,1430,794,553
630,text,861,534,85,19,100_median.png,1024,1430,946,553
631,text,233,561,52,14,100_median.png,1024,1430,285,575
632,text,359,559,257,16,100_median.png,1024,1430,616,575
633,text,673,559,38,16,100_median.png,1024,1430,711,575
634,text,759,561,36,14,100_median.png,1024,1430,795,575
635,text,359,575,58,16,100_median.png,1024,1430,417,591
636,text,60,1154,94,24,100_median.png,1024,1430,154,1178
637,text,261,1149,58,20,100_median.png,1024,1430,319,1169
638,text,386,1154,48,24,100_median.png,1024,1430,434,1178
639,text,549,1149,46,18,100_median.png,1024,1430,595,1167
640,text,601,1151,37,16,100_median.png,1024,1430,638,1167
641,text,670,1154,60,24,100_median.png,1024,1430,730,1178
642,text,347,1255,133,18,100_median.png,1024,1430,480,1273
643,text,49,1277,42,16,100_median.png,1024,1430,91,1293
644,text,99,1279,42,14,100_median.png,1024,1430,141,1293
645,text,147,1277,245,17,100_median.png,1024,1430,392,1294
646,text,841,1278,82,20,100_median.png,1024,1430,923,1298
647,text,49,1297,172,18,100_median.png,1024,1430,221,1315
648,text,227,1297,84,16,100_median.png,1024,1430,311,1313
649,text,13,1347,270,20,100_median.png,1024,1430,283,1367
650,text,291,1349,82,18,100_median.png,1024,1430,373,1367
651,text,381,1347,410,20,100_median.png,1024,1430,791,1367
652,text,799,1347,138,20,100_median.png,1024,1430,937,1367
653,text,28,1367,208,22,100_median.png,1024,1430,236,1389
654,text,243,1367,97,20,100_median.png,1024,1430,340,1387
655,text,349,1367,147,20,100_median.png,1024,1430,496,1387
656,text,505,1367,95,20,100_median.png,1024,1430,600,1387
657,text,609,1367,130,20,100_median.png,1024,1430,739,1387
658,text,812,530,43,24,100_median.png,1024,1430,855,554
659,text,827,559,20,14,100_median.png,1024,1430,847,573
660,text,900,558,47,16,100_median.png,1024,1430,947,574
661,text,744,1154,46,26,100_median.png,1024,1430,790,1180
662,text,881,1150,64,19,100_median.png,1024,1430,945,1169
663,text,137,1200,39,17,100_median.png,1024,1430,176,1217
664,text,52,1197,77,22,100_median.png,1024,1430,129,1219
665,text,39,1254,300,18,100_median.png,1024,1430,339,1272
666,text,750,1368,169,20,100_median.png,1024,1430,919,1388
667,text,665,43,100,18,101.png,1024,1448,765,61
668,text,813,43,166,16,101.png,1024,1448,979,59
669,text,67,31,321,75,101.png,1024,1448,388,106
670,text,665,59,124,16,101.png,1024,1448,789,75
671,text,831,59,148,16,101.png,1024,1448,979,75
672,text,664,73,169,20,101.png,1024,1448,833,93
673,text,844,73,135,18,101.png,1024,1448,979,91
674,text,663,89,190,20,101.png,1024,1448,853,109
675,text,875,91,102,16,101.png,1024,1448,977,107
676,text,68,106,290,32,101.png,1024,1448,358,138
677,text,695,119,98,20,101.png,1024,1448,793,139
678,text,803,119,158,20,101.png,1024,1448,961,139
679,text,472,146,75,20,101.png,1024,1448,547,166
680,text,681,149,34,16,101.png,1024,1448,715,165
681,text,869,151,44,16,101.png,1024,1448,913,167
682,text,463,175,90,20,101.png,1024,1448,553,195
683,text,661,179,74,16,101.png,1024,1448,735,195
684,text,867,181,44,16,101.png,1024,1448,911,197
685,text,640,220,98,24,101.png,1024,1448,738,244
686,text,629,249,120,20,101.png,1024,1448,749,269
687,text,596,268,178,24,101.png,1024,1448,774,292
688,text,48,315,45,26,101.png,1024,1448,93,341
689,text,50,358,77,19,101.png,1024,1448,127,377
690,text,138,354,324,26,101.png,1024,1448,462,380
691,text,93,415,70,16,101.png,1024,1448,163,431
692,text,345,417,86,17,101.png,1024,1448,431,434
693,text,577,415,64,20,101.png,1024,1448,641,435
694,text,661,417,78,18,101.png,1024,1448,739,435
695,text,779,419,52,16,101.png,1024,1448,831,435
696,text,880,417,81,20,101.png,1024,1448,961,437
697,text,49,441,138,20,101.png,1024,1448,187,461
698,text,209,439,228,20,101.png,1024,1448,437,459
699,text,599,445,48,20,101.png,1024,1448,647,465
700,text,697,447,48,18,101.png,1024,1448,745,465
701,text,817,449,38,18,101.png,1024,1448,855,467
702,text,937,449,38,18,101.png,1024,1448,975,467
703,text,207,457,208,20,101.png,1024,1448,415,477
704,text,49,479,87,20,101.png,1024,1448,136,499
705,text,207,475,294,20,101.png,1024,1448,501,495
706,text,600,481,47,20,101.png,1024,1448,647,501
707,text,699,485,46,18,101.png,1024,1448,745,503
708,text,817,485,38,16,101.png,1024,1448,855,501
709,text,937,487,38,16,101.png,1024,1448,975,503
710,text,207,495,112,18,101.png,1024,1448,319,513
711,text,49,515,110,20,101.png,1024,1448,159,535
712,text,206,510,328,24,101.png,1024,1448,534,534
713,text,601,521,46,16,101.png,1024,1448,647,537
714,text,695,519,50,20,101.png,1024,1448,745,539
715,text,815,519,40,20,101.png,1024,1448,855,539
716,text,935,523,40,16,101.png,1024,1448,975,539
717,text,205,531,114,20,101.png,1024,1448,319,551
718,text,38,1159,185,14,101.png,1024,1448,223,1173
719,text,51,1193,38,16,101.png,1024,1448,89,1209
720,text,129,1191,60,20,101.png,1024,1448,189,1211
721,text,227,1193,68,18,101.png,1024,1448,295,1211
722,text,321,1193,90,18,101.png,1024,1448,411,1211
723,text,573,1189,56,18,101.png,1024,1448,629,1207
724,text,907,1191,48,18,101.png,1024,1448,955,1209
725,text,57,1221,22,18,101.png,1024,1448,79,1239
726,text,165,1223,46,18,101.png,1024,1448,211,1241
727,text,263,1223,40,18,101.png,1024,1448,303,1241
728,text,385,1225,40,16,101.png,1024,1448,425,1241
729,text,573,1221,30,16,101.png,1024,1448,603,1237
730,text,915,1223,38,16,101.png,1024,1448,953,1239
731,text,34,1248,296,24,101.png,1024,1448,330,1272
732,text,571,1251,68,20,101.png,1024,1448,639,1271
733,text,905,1253,48,20,101.png,1024,1448,953,1273
734,text,35,1280,448,21,101.png,1024,1448,483,1301
735,text,27,1371,347,21,101.png,1024,1448,374,1392
736,text,380,1371,82,21,101.png,1024,1448,462,1392
737,text,807,1374,152,19,101.png,1024,1448,959,1393
738,text,220,1392,246,19,101.png,1024,1448,466,1411
739,text,633,1393,78,19,101.png,1024,1448,711,1412
740,text,723,1395,44,18,101.png,1024,1448,767,1413
741,text,169,1411,158,20,101.png,1024,1448,327,1431
742,text,334,1412,156,19,101.png,1024,1448,490,1431
743,text,496,1414,159,21,101.png,1024,1448,655,1435
744,text,152,322,43,15,101.png,1024,1448,195,337
745,text,692,1373,104,19,101.png,1024,1448,796,1392
746,text,561,1373,122,18,101.png,1024,1448,683,1391
747,text,468,1372,86,19,101.png,1024,1448,554,1391
748,text,476,1392,68,18,101.png,1024,1448,544,1410
749,text,552,1394,69,17,101.png,1024,1448,621,1411
750,text,664,1412,160,21,101.png,1024,1448,824,1433
751,text,665,43,100,18,101_contrasted.png,1024,1448,765,61
752,text,813,43,166,16,101_contrasted.png,1024,1448,979,59
753,text,67,31,321,75,101_contrasted.png,1024,1448,388,106
754,text,665,59,124,16,101_contrasted.png,1024,1448,789,75
755,text,831,59,148,16,101_contrasted.png,1024,1448,979,75
756,text,664,73,169,20,101_contrasted.png,1024,1448,833,93
757,text,844,73,135,18,101_contrasted.png,1024,1448,979,91
758,text,663,89,190,20,101_contrasted.png,1024,1448,853,109
759,text,875,91,102,16,101_contrasted.png,1024,1448,977,107
760,text,68,106,290,32,101_contrasted.png,1024,1448,358,138
761,text,695,119,98,20,101_contrasted.png,1024,1448,793,139
762,text,803,119,158,20,101_contrasted.png,1024,1448,961,139
763,text,472,146,75,20,101_contrasted.png,1024,1448,547,166
764,text,681,149,34,16,101_contrasted.png,1024,1448,715,165
765,text,869,151,44,16,101_contrasted.png,1024,1448,913,167
766,text,463,175,90,20,101_contrasted.png,1024,1448,553,195
767,text,661,179,74,16,101_contrasted.png,1024,1448,735,195
768,text,867,181,44,16,101_contrasted.png,1024,1448,911,197
769,text,640,220,98,24,101_contrasted.png,1024,1448,738,244
770,text,629,249,120,20,101_contrasted.png,1024,1448,749,269
771,text,596,268,178,24,101_contrasted.png,1024,1448,774,292
772,text,48,315,45,26,101_contrasted.png,1024,1448,93,341
773,text,50,358,77,19,101_contrasted.png,1024,1448,127,377
774,text,138,354,324,26,101_contrasted.png,1024,1448,462,380
775,text,93,415,70,16,101_contrasted.png,1024,1448,163,431
776,text,345,417,86,17,101_contrasted.png,1024,1448,431,434
777,text,577,415,64,20,101_contrasted.png,1024,1448,641,435
778,text,661,417,78,18,101_contrasted.png,1024,1448,739,435
779,text,779,419,52,16,101_contrasted.png,1024,1448,831,435
780,text,880,417,81,20,101_contrasted.png,1024,1448,961,437
781,text,49,441,138,20,101_contrasted.png,1024,1448,187,461
782,text,209,439,228,20,101_contrasted.png,1024,1448,437,459
783,text,599,445,48,20,101_contrasted.png,1024,1448,647,465
784,text,697,447,48,18,101_contrasted.png,1024,1448,745,465
785,text,817,449,38,18,101_contrasted.png,1024,1448,855,467
786,text,937,449,38,18,101_contrasted.png,1024,1448,975,467
787,text,207,457,208,20,101_contrasted.png,1024,1448,415,477
788,text,49,479,87,20,101_contrasted.png,1024,1448,136,499
789,text,207,475,294,20,101_contrasted.png,1024,1448,501,495
790,text,600,481,47,20,101_contrasted.png,1024,1448,647,501
791,text,699,485,46,18,101_contrasted.png,1024,1448,745,503
792,text,817,485,38,16,101_contrasted.png,1024,1448,855,501
793,text,937,487,38,16,101_contrasted.png,1024,1448,975,503
794,text,207,495,112,18,101_contrasted.png,1024,1448,319,513
795,text,49,515,110,20,101_contrasted.png,1024,1448,159,535
796,text,206,510,328,24,101_contrasted.png,1024,1448,534,534
797,text,601,521,46,16,101_contrasted.png,1024,1448,647,537
798,text,695,519,50,20,101_contrasted.png,1024,1448,745,539
799,text,815,519,40,20,101_contrasted.png,1024,1448,855,539
800,text,935,523,40,16,101_contrasted.png,1024,1448,975,539
801,text,205,531,114,20,101_contrasted.png,1024,1448,319,551
802,text,38,1159,185,14,101_contrasted.png,1024,1448,223,1173
803,text,51,1193,38,16,101_contrasted.png,1024,1448,89,1209
804,text,129,1191,60,20,101_contrasted.png,1024,1448,189,1211
805,text,227,1193,68,18,101_contrasted.png,1024,1448,295,1211
806,text,321,1193,90,18,101_contrasted.png,1024,1448,411,1211
807,text,573,1189,56,18,101_contrasted.png,1024,1448,629,1207
808,text,907,1191,48,18,101_contrasted.png,1024,1448,955,1209
809,text,57,1221,22,18,101_contrasted.png,1024,1448,79,1239
810,text,165,1223,46,18,101_contrasted.png,1024,1448,211,1241
811,text,263,1223,40,18,101_contrasted.png,1024,1448,303,1241
812,text,385,1225,40,16,101_contrasted.png,1024,1448,425,1241
813,text,573,1221,30,16,101_contrasted.png,1024,1448,603,1237
814,text,915,1223,38,16,101_contrasted.png,1024,1448,953,1239
815,text,34,1248,296,24,101_contrasted.png,1024,1448,330,1272
816,text,571,1251,68,20,101_contrasted.png,1024,1448,639,1271
817,text,905,1253,48,20,101_contrasted.png,1024,1448,953,1273
818,text,35,1280,448,21,101_contrasted.png,1024,1448,483,1301
819,text,27,1371,347,21,101_contrasted.png,1024,1448,374,1392
820,text,380,1371,82,21,101_contrasted.png,1024,1448,462,1392
821,text,807,1374,152,19,101_contrasted.png,1024,1448,959,1393
822,text,220,1392,246,19,101_contrasted.png,1024,1448,466,1411
823,text,633,1393,78,19,101_contrasted.png,1024,1448,711,1412
824,text,723,1395,44,18,101_contrasted.png,1024,1448,767,1413
825,text,169,1411,158,20,101_contrasted.png,1024,1448,327,1431
826,text,334,1412,156,19,101_contrasted.png,1024,1448,490,1431
827,text,496,1414,159,21,101_contrasted.png,1024,1448,655,1435
828,text,152,322,43,15,101_contrasted.png,1024,1448,195,337
829,text,692,1373,104,19,101_contrasted.png,1024,1448,796,1392
830,text,561,1373,122,18,101_contrasted.png,1024,1448,683,1391
831,text,468,1372,86,19,101_contrasted.png,1024,1448,554,1391
832,text,476,1392,68,18,101_contrasted.png,1024,1448,544,1410
833,text,552,1394,69,17,101_contrasted.png,1024,1448,621,1411
834,text,664,1412,160,21,101_contrasted.png,1024,1448,824,1433
835,text,665,43,100,18,101_denoise.png,1024,1448,765,61
836,text,813,43,166,16,101_denoise.png,1024,1448,979,59
837,text,67,31,321,75,101_denoise.png,1024,1448,388,106
838,text,665,59,124,16,101_denoise.png,1024,1448,789,75
839,text,831,59,148,16,101_denoise.png,1024,1448,979,75
840,text,664,73,169,20,101_denoise.png,1024,1448,833,93
841,text,844,73,135,18,101_denoise.png,1024,1448,979,91
842,text,663,89,190,20,101_denoise.png,1024,1448,853,109
843,text,875,91,102,16,101_denoise.png,1024,1448,977,107
844,text,68,106,290,32,101_denoise.png,1024,1448,358,138
845,text,695,119,98,20,101_denoise.png,1024,1448,793,139
846,text,803,119,158,20,101_denoise.png,1024,1448,961,139
847,text,472,146,75,20,101_denoise.png,1024,1448,547,166
848,text,681,149,34,16,101_denoise.png,1024,1448,715,165
849,text,869,151,44,16,101_denoise.png,1024,1448,913,167
850,text,463,175,90,20,101_denoise.png,1024,1448,553,195
851,text,661,179,74,16,101_denoise.png,1024,1448,735,195
852,text,867,181,44,16,101_denoise.png,1024,1448,911,197
853,text,640,220,98,24,101_denoise.png,1024,1448,738,244
854,text,629,249,120,20,101_denoise.png,1024,1448,749,269
855,text,596,268,178,24,101_denoise.png,1024,1448,774,292
856,text,48,315,45,26,101_denoise.png,1024,1448,93,341
857,text,50,358,77,19,101_denoise.png,1024,1448,127,377
858,text,138,354,324,26,101_denoise.png,1024,1448,462,380
859,text,93,415,70,16,101_denoise.png,1024,1448,163,431
860,text,345,417,86,17,101_denoise.png,1024,1448,431,434
861,text,577,415,64,20,101_denoise.png,1024,1448,641,435
862,text,661,417,78,18,101_denoise.png,1024,1448,739,435
863,text,779,419,52,16,101_denoise.png,1024,1448,831,435
864,text,880,417,81,20,101_denoise.png,1024,1448,961,437
865,text,49,441,138,20,101_denoise.png,1024,1448,187,461
866,text,209,439,228,20,101_denoise.png,1024,1448,437,459
867,text,599,445,48,20,101_denoise.png,1024,1448,647,465
868,text,697,447,48,18,101_denoise.png,1024,1448,745,465
869,text,817,449,38,18,101_denoise.png,1024,1448,855,467
870,text,937,449,38,18,101_denoise.png,1024,1448,975,467
871,text,207,457,208,20,101_denoise.png,1024,1448,415,477
872,text,49,479,87,20,101_denoise.png,1024,1448,136,499
873,text,207,475,294,20,101_denoise.png,1024,1448,501,495
874,text,600,481,47,20,101_denoise.png,1024,1448,647,501
875,text,699,485,46,18,101_denoise.png,1024,1448,745,503
876,text,817,485,38,16,101_denoise.png,1024,1448,855,501
877,text,937,487,38,16,101_denoise.png,1024,1448,975,503
878,text,207,495,112,18,101_denoise.png,1024,1448,319,513
879,text,49,515,110,20,101_denoise.png,1024,1448,159,535
880,text,206,510,328,24,101_denoise.png,1024,1448,534,534
881,text,601,521,46,16,101_denoise.png,1024,1448,647,537
882,text,695,519,50,20,101_denoise.png,1024,1448,745,539
883,text,815,519,40,20,101_denoise.png,1024,1448,855,539
884,text,935,523,40,16,101_denoise.png,1024,1448,975,539
885,text,205,531,114,20,101_denoise.png,1024,1448,319,551
886,text,38,1159,185,14,101_denoise.png,1024,1448,223,1173
887,text,51,1193,38,16,101_denoise.png,1024,1448,89,1209
888,text,129,1191,60,20,101_denoise.png,1024,1448,189,1211
889,text,227,1193,68,18,101_denoise.png,1024,1448,295,1211
890,text,321,1193,90,18,101_denoise.png,1024,1448,411,1211
891,text,573,1189,56,18,101_denoise.png,1024,1448,629,1207
892,text,907,1191,48,18,101_denoise.png,1024,1448,955,1209
893,text,57,1221,22,18,101_denoise.png,1024,1448,79,1239
894,text,165,1223,46,18,101_denoise.png,1024,1448,211,1241
895,text,263,1223,40,18,101_denoise.png,1024,1448,303,1241
896,text,385,1225,40,16,101_denoise.png,1024,1448,425,1241
897,text,573,1221,30,16,101_denoise.png,1024,1448,603,1237
898,text,915,1223,38,16,101_denoise.png,1024,1448,953,1239
899,text,34,1248,296,24,101_denoise.png,1024,1448,330,1272
900,text,571,1251,68,20,101_denoise.png,1024,1448,639,1271
901,text,905,1253,48,20,101_denoise.png,1024,1448,953,1273
902,text,35,1280,448,21,101_denoise.png,1024,1448,483,1301
903,text,27,1371,347,21,101_denoise.png,1024,1448,374,1392
904,text,380,1371,82,21,101_denoise.png,1024,1448,462,1392
905,text,807,1374,152,19,101_denoise.png,1024,1448,959,1393
906,text,220,1392,246,19,101_denoise.png,1024,1448,466,1411
907,text,633,1393,78,19,101_denoise.png,1024,1448,711,1412
908,text,723,1395,44,18,101_denoise.png,1024,1448,767,1413
909,text,169,1411,158,20,101_denoise.png,1024,1448,327,1431
910,text,334,1412,156,19,101_denoise.png,1024,1448,490,1431
911,text,496,1414,159,21,101_denoise.png,1024,1448,655,1435
912,text,152,322,43,15,101_denoise.png,1024,1448,195,337
913,text,692,1373,104,19,101_denoise.png,1024,1448,796,1392
914,text,561,1373,122,18,101_denoise.png,1024,1448,683,1391
915,text,468,1372,86,19,101_denoise.png,1024,1448,554,1391
916,text,476,1392,68,18,101_denoise.png,1024,1448,544,1410
917,text,552,1394,69,17,101_denoise.png,1024,1448,621,1411
918,text,664,1412,160,21,101_denoise.png,1024,1448,824,1433
919,text,665,43,100,18,101_median.png,1024,1448,765,61
920,text,813,43,166,16,101_median.png,1024,1448,979,59
921,text,67,31,321,75,101_median.png,1024,1448,388,106
922,text,665,59,124,16,101_median.png,1024,1448,789,75
923,text,831,59,148,16,101_median.png,1024,1448,979,75
924,text,664,73,169,20,101_median.png,1024,1448,833,93
925,text,844,73,135,18,101_median.png,1024,1448,979,91
926,text,663,89,190,20,101_median.png,1024,1448,853,109
927,text,875,91,102,16,101_median.png,1024,1448,977,107
928,text,68,106,290,32,101_median.png,1024,1448,358,138
929,text,803,119,158,20,101_median.png,1024,1448,961,139
930,text,472,146,75,20,101_median.png,1024,1448,547,166
931,text,681,149,34,16,101_median.png,1024,1448,715,165
932,text,869,151,44,16,101_median.png,1024,1448,913,167
933,text,463,175,90,20,101_median.png,1024,1448,553,195
934,text,661,179,74,16,101_median.png,1024,1448,735,195
935,text,867,181,44,16,101_median.png,1024,1448,911,197
936,text,640,220,98,24,101_median.png,1024,1448,738,244
937,text,629,249,120,20,101_median.png,1024,1448,749,269
938,text,596,268,178,24,101_median.png,1024,1448,774,292
939,text,48,315,45,26,101_median.png,1024,1448,93,341
940,text,50,358,77,19,101_median.png,1024,1448,127,377
941,text,138,354,324,26,101_median.png,1024,1448,462,380
942,text,93,415,70,16,101_median.png,1024,1448,163,431
943,text,345,417,86,17,101_median.png,1024,1448,431,434
944,text,577,415,64,20,101_median.png,1024,1448,641,435
945,text,661,417,78,18,101_median.png,1024,1448,739,435
946,text,779,419,52,16,101_median.png,1024,1448,831,435
947,text,880,417,81,20,101_median.png,1024,1448,961,437
948,text,49,441,138,20,101_median.png,1024,1448,187,461
949,text,209,439,228,20,101_median.png,1024,1448,437,459
950,text,599,445,48,20,101_median.png,1024,1448,647,465
951,text,697,447,48,18,101_median.png,1024,1448,745,465
952,text,817,449,38,18,101_median.png,1024,1448,855,467
953,text,937,449,38,18,101_median.png,1024,1448,975,467
954,text,207,457,208,20,101_median.png,1024,1448,415,477
955,text,49,479,87,20,101_median.png,1024,1448,136,499
956,text,207,475,294,20,101_median.png,1024,1448,501,495
957,text,600,481,47,20,101_median.png,1024,1448,647,501
958,text,699,485,46,18,101_median.png,1024,1448,745,503
959,text,817,485,38,16,101_median.png,1024,1448,855,501
960,text,937,487,38,16,101_median.png,1024,1448,975,503
961,text,207,495,112,18,101_median.png,1024,1448,319,513
962,text,49,515,110,20,101_median.png,1024,1448,159,535
963,text,206,510,328,24,101_median.png,1024,1448,534,534
964,text,601,521,46,16,101_median.png,1024,1448,647,537
965,text,695,519,50,20,101_median.png,1024,1448,745,539
966,text,815,519,40,20,101_median.png,1024,1448,855,539
967,text,935,523,40,16,101_median.png,1024,1448,975,539
968,text,205,531,114,20,101_median.png,1024,1448,319,551
969,text,38,1159,185,14,101_median.png,1024,1448,223,1173
970,text,51,1193,38,16,101_median.png,1024,1448,89,1209
971,text,129,1191,60,20,101_median.png,1024,1448,189,1211
972,text,227,1193,68,18,101_median.png,1024,1448,295,1211
973,text,321,1193,90,18,101_median.png,1024,1448,411,1211
974,text,573,1189,56,18,101_median.png,1024,1448,629,1207
975,text,907,1191,48,18,101_median.png,1024,1448,955,1209
976,text,57,1221,22,18,101_median.png,1024,1448,79,1239
977,text,165,1223,46,18,101_median.png,1024,1448,211,1241
978,text,263,1223,40,18,101_median.png,1024,1448,303,1241
979,text,385,1225,40,16,101_median.png,1024,1448,425,1241
980,text,573,1221,30,16,101_median.png,1024,1448,603,1237
981,text,915,1223,38,16,101_median.png,1024,1448,953,1239
982,text,34,1248,296,24,101_median.png,1024,1448,330,1272
983,text,571,1251,68,20,101_median.png,1024,1448,639,1271
984,text,905,1253,48,20,101_median.png,1024,1448,953,1273
985,text,35,1280,448,21,101_median.png,1024,1448,483,1301
986,text,27,1371,347,21,101_median.png,1024,1448,374,1392
987,text,380,1371,82,21,101_median.png,1024,1448,462,1392
988,text,807,1374,152,19,101_median.png,1024,1448,959,1393
989,text,220,1392,246,19,101_median.png,1024,1448,466,1411
990,text,633,1393,78,19,101_median.png,1024,1448,711,1412
991,text,723,1395,44,18,101_median.png,1024,1448,767,1413
992,text,169,1411,158,20,101_median.png,1024,1448,327,1431
993,text,334,1412,156,19,101_median.png,1024,1448,490,1431
994,text,496,1414,159,21,101_median.png,1024,1448,655,1435
995,text,152,322,43,15,101_median.png,1024,1448,195,337
996,text,692,1373,104,19,101_median.png,1024,1448,796,1392
997,text,561,1373,122,18,101_median.png,1024,1448,683,1391
998,text,468,1372,86,19,101_median.png,1024,1448,554,1391
999,text,476,1392,68,18,101_median.png,1024,1448,544,1410
1000,text,552,1394,69,17,101_median.png,1024,1448,621,1411
1001,text,664,1412,160,21,101_median.png,1024,1448,824,1433
1002,text,572,224,108,24,102.png,1024,1448,680,248
1003,text,115,247,191,20,102.png,1024,1448,306,267
1004,text,362,242,94,24,102.png,1024,1448,456,266
1005,text,572,254,190,24,102.png,1024,1448,762,278
1006,text,142,292,48,24,102.png,1024,1448,190,316
1007,text,276,292,74,24,102.png,1024,1448,350,316
1008,text,422,292,58,24,102.png,1024,1448,480,316
1009,text,660,304,146,26,102.png,1024,1448,806,330
1010,text,136,322,72,24,102.png,1024,1448,208,346
1011,text,268,322,82,24,102.png,1024,1448,350,346
1012,text,98,382,228,24,102.png,1024,1448,326,406
1013,text,380,384,128,24,102.png,1024,1448,508,408
1014,text,564,384,170,24,102.png,1024,1448,734,408
1015,text,778,382,190,28,102.png,1024,1448,968,410
1016,text,602,414,102,24,102.png,1024,1448,704,438
1017,text,88,474,98,24,102.png,1024,1448,186,498
1018,text,232,474,36,24,102.png,1024,1448,268,498
1019,text,290,474,114,26,102.png,1024,1448,404,500
1020,text,702,472,42,24,102.png,1024,1448,744,496
1021,text,763,477,66,20,102.png,1024,1448,829,497
1022,text,858,474,36,24,102.png,1024,1448,894,498
1023,text,906,474,64,24,102.png,1024,1448,970,498
1024,text,105,517,72,20,102.png,1024,1448,177,537
1025,text,233,517,22,20,102.png,1024,1448,255,537
1026,text,272,516,137,21,102.png,1024,1448,409,537
1027,text,704,516,40,24,102.png,1024,1448,744,540
1028,text,771,519,58,20,102.png,1024,1448,829,539
1029,text,937,519,58,20,102.png,1024,1448,995,539
1030,text,273,535,168,20,102.png,1024,1448,441,555
1031,text,440,888,40,32,102.png,1024,1448,480,920
1032,text,377,917,54,36,102.png,1024,1448,431,953
1033,text,76,1134,64,24,102.png,1024,1448,140,1158
1034,text,190,1134,42,24,102.png,1024,1448,232,1158
1035,text,255,1135,72,20,102.png,1024,1448,327,1155
1036,text,497,1133,34,20,102.png,1024,1448,531,1153
1037,text,650,1130,68,24,102.png,1024,1448,718,1154
1038,text,830,1130,94,24,102.png,1024,1448,924,1154
1039,text,122,1164,60,24,102.png,1024,1448,182,1188
1040,text,207,1165,36,20,102.png,1024,1448,243,1185
1041,text,309,1167,46,20,102.png,1024,1448,355,1187
1042,text,477,1169,56,20,102.png,1024,1448,533,1189
1043,text,665,1169,48,20,102.png,1024,1448,713,1189
1044,text,861,1169,65,28,102.png,1024,1448,926,1197
1045,text,388,1198,418,26,102.png,1024,1448,806,1224
1046,text,385,1225,162,20,102.png,1024,1448,547,1245
1047,text,691,1227,40,20,102.png,1024,1448,731,1247
1048,text,158,1267,218,23,102.png,1024,1448,376,1290
1049,text,110,1290,142,18,102.png,1024,1448,252,1308
1050,text,263,1289,114,20,102.png,1024,1448,377,1309
1051,text,388,1291,110,18,102.png,1024,1448,498,1309
1052,text,511,1290,143,19,102.png,1024,1448,654,1309
1053,text,658,1291,235,18,102.png,1024,1448,893,1309
1054,text,103,1309,93,20,102.png,1024,1448,196,1329
1055,text,207,1309,132,20,102.png,1024,1448,339,1329
1056,text,353,1309,238,20,102.png,1024,1448,591,1329
1057,text,185,1331,323,19,102.png,1024,1448,508,1350
1058,text,518,1330,297,20,102.png,1024,1448,815,1350
1059,text,136,1350,549,20,102.png,1024,1448,685,1370
1060,text,697,1349,145,21,102.png,1024,1448,842,1370
1061,text,210,1370,424,20,102.png,1024,1448,634,1390
1062,text,643,1370,146,19,102.png,1024,1448,789,1389
1063,text,425,1393,150,16,102.png,1024,1448,575,1409
1064,text,550,947,134,23,102.png,1024,1448,684,970
1065,text,529,941,35,16,102.png,1024,1448,564,957
1066,text,513,961,35,15,102.png,1024,1448,548,976
1067,text,613,971,32,17,102.png,1024,1448,645,988
1068,text,438,327,15,17,102.png,1024,1448,453,344
1069,text,383,1269,464,22,102.png,1024,1448,847,1291
1070,text,600,1311,103,18,102.png,1024,1448,703,1329
1071,text,906,1325,0,0,102.png,1024,1448,906,1325
1072,text,711,1309,183,18,102.png,1024,1448,894,1327
1073,text,572,224,108,24,102_contrasted.png,1024,1448,680,248
1074,text,115,247,191,20,102_contrasted.png,1024,1448,306,267
1075,text,362,242,94,24,102_contrasted.png,1024,1448,456,266
1076,text,572,254,190,24,102_contrasted.png,1024,1448,762,278
1077,text,142,292,48,24,102_contrasted.png,1024,1448,190,316
1078,text,276,292,74,24,102_contrasted.png,1024,1448,350,316
1079,text,422,292,58,24,102_contrasted.png,1024,1448,480,316
1080,text,660,304,146,26,102_contrasted.png,1024,1448,806,330
1081,text,136,322,72,24,102_contrasted.png,1024,1448,208,346
1082,text,268,322,82,24,102_contrasted.png,1024,1448,350,346
1083,text,98,382,228,24,102_contrasted.png,1024,1448,326,406
1084,text,380,384,128,24,102_contrasted.png,1024,1448,508,408
1085,text,564,384,170,24,102_contrasted.png,1024,1448,734,408
1086,text,778,382,190,28,102_contrasted.png,1024,1448,968,410
1087,text,602,414,102,24,102_contrasted.png,1024,1448,704,438
1088,text,88,474,98,24,102_contrasted.png,1024,1448,186,498
1089,text,232,474,36,24,102_contrasted.png,1024,1448,268,498
1090,text,290,474,114,26,102_contrasted.png,1024,1448,404,500
1091,text,702,472,42,24,102_contrasted.png,1024,1448,744,496
1092,text,763,477,66,20,102_contrasted.png,1024,1448,829,497
1093,text,858,474,36,24,102_contrasted.png,1024,1448,894,498
1094,text,906,474,64,24,102_contrasted.png,1024,1448,970,498
1095,text,105,517,72,20,102_contrasted.png,1024,1448,177,537
1096,text,233,517,22,20,102_contrasted.png,1024,1448,255,537
1097,text,272,516,137,21,102_contrasted.png,1024,1448,409,537
1098,text,704,516,40,24,102_contrasted.png,1024,1448,744,540
1099,text,771,519,58,20,102_contrasted.png,1024,1448,829,539
1100,text,937,519,58,20,102_contrasted.png,1024,1448,995,539
1101,text,273,535,168,20,102_contrasted.png,1024,1448,441,555
1102,text,440,888,40,32,102_contrasted.png,1024,1448,480,920
1103,text,377,917,54,36,102_contrasted.png,1024,1448,431,953
1104,text,76,1134,64,24,102_contrasted.png,1024,1448,140,1158
1105,text,190,1134,42,24,102_contrasted.png,1024,1448,232,1158
1106,text,255,1135,72,20,102_contrasted.png,1024,1448,327,1155
1107,text,497,1133,34,20,102_contrasted.png,1024,1448,531,1153
1108,text,650,1130,68,24,102_contrasted.png,1024,1448,718,1154
1109,text,830,1130,94,24,102_contrasted.png,1024,1448,924,1154
1110,text,122,1164,60,24,102_contrasted.png,1024,1448,182,1188
1111,text,207,1165,36,20,102_contrasted.png,1024,1448,243,1185
1112,text,309,1167,46,20,102_contrasted.png,1024,1448,355,1187
1113,text,477,1169,56,20,102_contrasted.png,1024,1448,533,1189
1114,text,665,1169,48,20,102_contrasted.png,1024,1448,713,1189
1115,text,861,1169,65,28,102_contrasted.png,1024,1448,926,1197
1116,text,388,1198,418,26,102_contrasted.png,1024,1448,806,1224
1117,text,385,1225,162,20,102_contrasted.png,1024,1448,547,1245
1118,text,691,1227,40,20,102_contrasted.png,1024,1448,731,1247
1119,text,158,1267,218,23,102_contrasted.png,1024,1448,376,1290
1120,text,110,1290,142,18,102_contrasted.png,1024,1448,252,1308
1121,text,263,1289,114,20,102_contrasted.png,1024,1448,377,1309
1122,text,388,1291,110,18,102_contrasted.png,1024,1448,498,1309
1123,text,511,1290,143,19,102_contrasted.png,1024,1448,654,1309
1124,text,658,1291,235,18,102_contrasted.png,1024,1448,893,1309
1125,text,103,1309,93,20,102_contrasted.png,1024,1448,196,1329
1126,text,207,1309,132,20,102_contrasted.png,1024,1448,339,1329
1127,text,353,1309,238,20,102_contrasted.png,1024,1448,591,1329
1128,text,185,1331,323,19,102_contrasted.png,1024,1448,508,1350
1129,text,518,1330,297,20,102_contrasted.png,1024,1448,815,1350
1130,text,136,1350,549,20,102_contrasted.png,1024,1448,685,1370
1131,text,697,1349,145,21,102_contrasted.png,1024,1448,842,1370
1132,text,210,1370,424,20,102_contrasted.png,1024,1448,634,1390
1133,text,643,1370,146,19,102_contrasted.png,1024,1448,789,1389
1134,text,425,1393,150,16,102_contrasted.png,1024,1448,575,1409
1135,text,550,947,134,23,102_contrasted.png,1024,1448,684,970
1136,text,529,941,35,16,102_contrasted.png,1024,1448,564,957
1137,text,513,961,35,15,102_contrasted.png,1024,1448,548,976
1138,text,613,971,32,17,102_contrasted.png,1024,1448,645,988
1139,text,438,327,15,17,102_contrasted.png,1024,1448,453,344
1140,text,383,1269,464,22,102_contrasted.png,1024,1448,847,1291
1141,text,600,1311,103,18,102_contrasted.png,1024,1448,703,1329
1142,text,906,1325,0,0,102_contrasted.png,1024,1448,906,1325
1143,text,711,1309,183,18,102_contrasted.png,1024,1448,894,1327
1144,text,572,224,108,24,102_denoise.png,1024,1448,680,248
1145,text,115,247,191,20,102_denoise.png,1024,1448,306,267
1146,text,362,242,94,24,102_denoise.png,1024,1448,456,266
1147,text,572,254,190,24,102_denoise.png,1024,1448,762,278
1148,text,142,292,48,24,102_denoise.png,1024,1448,190,316
1149,text,276,292,74,24,102_denoise.png,1024,1448,350,316
1150,text,422,292,58,24,102_denoise.png,1024,1448,480,316
1151,text,660,304,146,26,102_denoise.png,1024,1448,806,330
1152,text,136,322,72,24,102_denoise.png,1024,1448,208,346
1153,text,268,322,82,24,102_denoise.png,1024,1448,350,346
1154,text,98,382,228,24,102_denoise.png,1024,1448,326,406
1155,text,380,384,128,24,102_denoise.png,1024,1448,508,408
1156,text,564,384,170,24,102_denoise.png,1024,1448,734,408
1157,text,778,382,190,28,102_denoise.png,1024,1448,968,410
1158,text,602,414,102,24,102_denoise.png,1024,1448,704,438
1159,text,88,474,98,24,102_denoise.png,1024,1448,186,498
1160,text,232,474,36,24,102_denoise.png,1024,1448,268,498
1161,text,290,474,114,26,102_denoise.png,1024,1448,404,500
1162,text,702,472,42,24,102_denoise.png,1024,1448,744,496
1163,text,763,477,66,20,102_denoise.png,1024,1448,829,497
1164,text,858,474,36,24,102_denoise.png,1024,1448,894,498
1165,text,906,474,64,24,102_denoise.png,1024,1448,970,498
1166,text,105,517,72,20,102_denoise.png,1024,1448,177,537
1167,text,233,517,22,20,102_denoise.png,1024,1448,255,537
1168,text,272,516,137,21,102_denoise.png,1024,1448,409,537
1169,text,704,516,40,24,102_denoise.png,1024,1448,744,540
1170,text,771,519,58,20,102_denoise.png,1024,1448,829,539
1171,text,937,519,58,20,102_denoise.png,1024,1448,995,539
1172,text,273,535,168,20,102_denoise.png,1024,1448,441,555
1173,text,440,888,40,32,102_denoise.png,1024,1448,480,920
1174,text,377,917,54,36,102_denoise.png,1024,1448,431,953
1175,text,76,1134,64,24,102_denoise.png,1024,1448,140,1158
1176,text,190,1134,42,24,102_denoise.png,1024,1448,232,1158
1177,text,255,1135,72,20,102_denoise.png,1024,1448,327,1155
1178,text,497,1133,34,20,102_denoise.png,1024,1448,531,1153
1179,text,650,1130,68,24,102_denoise.png,1024,1448,718,1154
1180,text,830,1130,94,24,102_denoise.png,1024,1448,924,1154
1181,text,122,1164,60,24,102_denoise.png,1024,1448,182,1188
1182,text,207,1165,36,20,102_denoise.png,1024,1448,243,1185
1183,text,309,1167,46,20,102_denoise.png,1024,1448,355,1187
1184,text,477,1169,56,20,102_denoise.png,1024,1448,533,1189
1185,text,665,1169,48,20,102_denoise.png,1024,1448,713,1189
1186,text,861,1169,65,28,102_denoise.png,1024,1448,926,1197
1187,text,388,1198,418,26,102_denoise.png,1024,1448,806,1224
1188,text,385,1225,162,20,102_denoise.png,1024,1448,547,1245
1189,text,691,1227,40,20,102_denoise.png,1024,1448,731,1247
1190,text,158,1267,218,23,102_denoise.png,1024,1448,376,1290
1191,text,110,1290,142,18,102_denoise.png,1024,1448,252,1308
1192,text,263,1289,114,20,102_denoise.png,1024,1448,377,1309
1193,text,388,1291,110,18,102_denoise.png,1024,1448,498,1309
1194,text,511,1290,143,19,102_denoise.png,1024,1448,654,1309
1195,text,658,1291,235,18,102_denoise.png,1024,1448,893,1309
1196,text,103,1309,93,20,102_denoise.png,1024,1448,196,1329
1197,text,207,1309,132,20,102_denoise.png,1024,1448,339,1329
1198,text,353,1309,238,20,102_denoise.png,1024,1448,591,1329
1199,text,185,1331,323,19,102_denoise.png,1024,1448,508,1350
1200,text,518,1330,297,20,102_denoise.png,1024,1448,815,1350
1201,text,136,1350,549,20,102_denoise.png,1024,1448,685,1370
1202,text,697,1349,145,21,102_denoise.png,1024,1448,842,1370
1203,text,210,1370,424,20,102_denoise.png,1024,1448,634,1390
1204,text,643,1370,146,19,102_denoise.png,1024,1448,789,1389
1205,text,425,1393,150,16,102_denoise.png,1024,1448,575,1409
1206,text,550,947,134,23,102_denoise.png,1024,1448,684,970
1207,text,529,941,35,16,102_denoise.png,1024,1448,564,957
1208,text,513,961,35,15,102_denoise.png,1024,1448,548,976
1209,text,613,971,32,17,102_denoise.png,1024,1448,645,988
1210,text,438,327,15,17,102_denoise.png,1024,1448,453,344
1211,text,383,1269,464,22,102_denoise.png,1024,1448,847,1291
1212,text,600,1311,103,18,102_denoise.png,1024,1448,703,1329
1213,text,906,1325,0,0,102_denoise.png,1024,1448,906,1325
1214,text,711,1309,183,18,102_denoise.png,1024,1448,894,1327
1215,text,572,224,108,24,102_median.png,1024,1448,680,248
1216,text,115,247,191,20,102_median.png,1024,1448,306,267
1217,text,362,242,94,24,102_median.png,1024,1448,456,266
1218,text,572,254,190,24,102_median.png,1024,1448,762,278
1219,text,142,292,48,24,102_median.png,1024,1448,190,316
1220,text,276,292,74,24,102_median.png,1024,1448,350,316
1221,text,422,292,58,24,102_median.png,1024,1448,480,316
1222,text,660,304,146,26,102_median.png,1024,1448,806,330
1223,text,136,322,72,24,102_median.png,1024,1448,208,346
1224,text,268,322,82,24,102_median.png,1024,1448,350,346
1225,text,98,382,228,24,102_median.png,1024,1448,326,406
1226,text,380,384,128,24,102_median.png,1024,1448,508,408
1227,text,564,384,170,24,102_median.png,1024,1448,734,408
1228,text,778,382,190,28,102_median.png,1024,1448,968,410
1229,text,602,414,102,24,102_median.png,1024,1448,704,438
1230,text,88,474,98,24,102_median.png,1024,1448,186,498
1231,text,232,474,36,24,102_median.png,1024,1448,268,498
1232,text,290,474,114,26,102_median.png,1024,1448,404,500
1233,text,702,472,42,24,102_median.png,1024,1448,744,496
1234,text,763,477,66,20,102_median.png,1024,1448,829,497
1235,text,858,474,36,24,102_median.png,1024,1448,894,498
1236,text,906,474,64,24,102_median.png,1024,1448,970,498
1237,text,105,517,72,20,102_median.png,1024,1448,177,537
1238,text,233,517,22,20,102_median.png,1024,1448,255,537
1239,text,272,516,137,21,102_median.png,1024,1448,409,537
1240,text,704,516,40,24,102_median.png,1024,1448,744,540
1241,text,771,519,58,20,102_median.png,1024,1448,829,539
1242,text,937,519,58,20,102_median.png,1024,1448,995,539
1243,text,273,535,168,20,102_median.png,1024,1448,441,555
1244,text,440,888,40,32,102_median.png,1024,1448,480,920
1245,text,377,917,54,36,102_median.png,1024,1448,431,953
1246,text,76,1134,64,24,102_median.png,1024,1448,140,1158
1247,text,190,1134,42,24,102_median.png,1024,1448,232,1158
1248,text,255,1135,72,20,102_median.png,1024,1448,327,1155
1249,text,497,1133,34,20,102_median.png,1024,1448,531,1153
1250,text,650,1130,68,24,102_median.png,1024,1448,718,1154
1251,text,830,1130,94,24,102_median.png,1024,1448,924,1154
1252,text,122,1164,60,24,102_median.png,1024,1448,182,1188
1253,text,207,1165,36,20,102_median.png,1024,1448,243,1185
1254,text,309,1167,46,20,102_median.png,1024,1448,355,1187
1255,text,477,1169,56,20,102_median.png,1024,1448,533,1189
1256,text,665,1169,48,20,102_median.png,1024,1448,713,1189
1257,text,861,1169,65,28,102_median.png,1024,1448,926,1197
1258,text,388,1198,418,26,102_median.png,1024,1448,806,1224
1259,text,385,1225,162,20,102_median.png,1024,1448,547,1245
1260,text,691,1227,40,20,102_median.png,1024,1448,731,1247
1261,text,158,1267,218,23,102_median.png,1024,1448,376,1290
1262,text,110,1290,142,18,102_median.png,1024,1448,252,1308
1263,text,263,1289,114,20,102_median.png,1024,1448,377,1309
1264,text,388,1291,110,18,102_median.png,1024,1448,498,1309
1265,text,511,1290,143,19,102_median.png,1024,1448,654,1309
1266,text,658,1291,235,18,102_median.png,1024,1448,893,1309
1267,text,103,1309,93,20,102_median.png,1024,1448,196,1329
1268,text,207,1309,132,20,102_median.png,1024,1448,339,1329
1269,text,353,1309,238,20,102_median.png,1024,1448,591,1329
1270,text,185,1331,323,19,102_median.png,1024,1448,508,1350
1271,text,518,1330,297,20,102_median.png,1024,1448,815,1350
1272,text,136,1350,549,20,102_median.png,1024,1448,685,1370
1273,text,697,1349,145,21,102_median.png,1024,1448,842,1370
1274,text,210,1370,424,20,102_median.png,1024,1448,634,1390
1275,text,643,1370,146,19,102_median.png,1024,1448,789,1389
1276,text,425,1393,150,16,102_median.png,1024,1448,575,1409
1277,text,550,947,134,23,102_median.png,1024,1448,684,970
1278,text,529,941,35,16,102_median.png,1024,1448,564,957
1279,text,513,961,35,15,102_median.png,1024,1448,548,976
1280,text,613,971,32,17,102_median.png,1024,1448,645,988
1281,text,438,327,15,17,102_median.png,1024,1448,453,344
1282,text,383,1269,464,22,102_median.png,1024,1448,847,1291
1283,text,600,1311,103,18,102_median.png,1024,1448,703,1329
1284,text,906,1325,0,0,102_median.png,1024,1448,906,1325
1285,text,711,1309,183,18,102_median.png,1024,1448,894,1327
1286,text,136,40,214,52,103.png,1024,1448,350,92
1287,text,700,58,232,32,103.png,1024,1448,932,90
1288,text,245,93,102,14,103.png,1024,1448,347,107
1289,text,47,177,34,20,103.png,1024,1448,81,197
1290,text,91,177,142,20,103.png,1024,1448,233,197
1291,text,620,180,122,24,103.png,1024,1448,742,204
1292,text,772,179,122,27,103.png,1024,1448,894,206
1293,text,53,203,64,18,103.png,1024,1448,117,221
1294,text,249,199,128,20,103.png,1024,1448,377,219
1295,text,511,239,100,20,103.png,1024,1448,611,259
1296,text,634,238,140,19,103.png,1024,1448,774,257
1297,text,513,261,98,20,103.png,1024,1448,611,281
1298,text,37,281,134,20,103.png,1024,1448,171,301
1299,text,517,285,88,20,103.png,1024,1448,605,305
1300,text,631,281,84,20,103.png,1024,1448,715,301
1301,text,34,314,152,24,103.png,1024,1448,186,338
1302,text,222,312,64,24,103.png,1024,1448,286,336
1303,text,514,323,168,23,103.png,1024,1448,682,346
1304,text,34,350,160,26,103.png,1024,1448,194,376
1305,text,221,351,72,20,103.png,1024,1448,293,371
1306,text,513,347,299,24,103.png,1024,1448,812,371
1307,text,515,387,120,20,103.png,1024,1448,635,407
1308,text,513,407,116,20,103.png,1024,1448,629,427
1309,text,31,455,94,18,103.png,1024,1448,125,473
1310,text,155,455,40,16,103.png,1024,1448,195,471
1311,text,347,453,90,18,103.png,1024,1448,437,471
1312,text,547,449,30,20,103.png,1024,1448,577,469
1313,text,615,445,67,24,103.png,1024,1448,682,469
1314,text,701,449,58,16,103.png,1024,1448,759,465
1315,text,785,449,58,16,103.png,1024,1448,843,465
1316,text,883,447,84,16,103.png,1024,1448,967,463
1317,text,157,471,34,18,103.png,1024,1448,191,489
1318,text,781,465,32,18,103.png,1024,1448,813,483
1319,text,57,499,30,20,103.png,1024,1448,87,519
1320,text,206,492,266,24,103.png,1024,1448,472,516
1321,text,528,490,42,24,103.png,1024,1448,570,514
1322,text,608,492,54,24,103.png,1024,1448,662,516
1323,text,697,491,42,20,103.png,1024,1448,739,511
1324,text,776,490,54,24,103.png,1024,1448,830,514
1325,text,878,488,54,24,103.png,1024,1448,932,512
1326,text,206,514,170,24,103.png,1024,1448,376,538
1327,text,682,1044,88,24,103.png,1024,1448,770,1068
1328,text,870,1040,56,26,103.png,1024,1448,926,1066
1329,text,117,1063,40,16,103.png,1024,1448,157,1079
1330,text,177,1063,38,16,103.png,1024,1448,215,1079
1331,text,289,1063,38,14,103.png,1024,1448,327,1077
1332,text,349,1061,64,16,103.png,1024,1448,413,1077
1333,text,682,1076,100,26,103.png,1024,1448,782,1102
1334,text,868,1070,58,26,103.png,1024,1448,926,1096
1335,text,167,1093,42,20,103.png,1024,1448,209,1113
1336,text,279,1095,36,16,103.png,1024,1448,315,1111
1337,text,351,1091,42,20,103.png,1024,1448,393,1111
1338,text,684,1106,100,26,103.png,1024,1448,784,1132
1339,text,872,1102,56,26,103.png,1024,1448,928,1128
1340,text,684,1136,85,24,103.png,1024,1448,769,1160
1341,text,884,1134,44,24,103.png,1024,1448,928,1158
1342,text,119,1153,38,16,103.png,1024,1448,157,1169
1343,text,193,1151,42,16,103.png,1024,1448,235,1167
1344,text,353,1149,40,16,103.png,1024,1448,393,1165
1345,text,192,1175,300,19,103.png,1024,1448,492,1194
1346,text,504,1164,299,29,103.png,1024,1448,803,1193
1347,text,879,1162,57,22,103.png,1024,1448,936,1184
1348,text,54,1197,546,23,103.png,1024,1448,600,1220
1349,text,605,1201,70,16,103.png,1024,1448,675,1217
1350,text,683,1199,106,18,103.png,1024,1448,789,1217
1351,text,800,1201,77,16,103.png,1024,1448,877,1217
1352,text,159,1223,72,18,103.png,1024,1448,231,1241
1353,text,237,1221,156,18,103.png,1024,1448,393,1239
1354,text,399,1223,38,14,103.png,1024,1448,437,1237
1355,text,451,1221,296,18,103.png,1024,1448,747,1239
1356,text,753,1221,38,14,103.png,1024,1448,791,1235
1357,text,797,1221,42,14,103.png,1024,1448,839,1235
1358,text,159,1243,200,16,103.png,1024,1448,359,1259
1359,text,365,1243,26,14,103.png,1024,1448,391,1257
1360,text,395,1241,82,16,103.png,1024,1448,477,1257
1361,text,483,1241,134,16,103.png,1024,1448,617,1257
1362,text,131,498,18,23,103.png,1024,1448,149,521
1363,text,115,1095,18,19,103.png,1024,1448,133,1114
1364,text,621,1241,104,15,103.png,1024,1448,725,1256
1365,text,732,1242,108,13,103.png,1024,1448,840,1255
1366,text,136,40,214,52,103_contrasted.png,1024,1448,350,92
1367,text,700,58,232,32,103_contrasted.png,1024,1448,932,90
1368,text,245,93,102,14,103_contrasted.png,1024,1448,347,107
1369,text,47,177,34,20,103_contrasted.png,1024,1448,81,197
1370,text,91,177,142,20,103_contrasted.png,1024,1448,233,197
1371,text,620,180,122,24,103_contrasted.png,1024,1448,742,204
1372,text,772,179,122,27,103_contrasted.png,1024,1448,894,206
1373,text,53,203,64,18,103_contrasted.png,1024,1448,117,221
1374,text,249,199,128,20,103_contrasted.png,1024,1448,377,219
1375,text,511,239,100,20,103_contrasted.png,1024,1448,611,259
1376,text,634,238,140,19,103_contrasted.png,1024,1448,774,257
1377,text,513,261,98,20,103_contrasted.png,1024,1448,611,281
1378,text,37,281,134,20,103_contrasted.png,1024,1448,171,301
1379,text,517,285,88,20,103_contrasted.png,1024,1448,605,305
1380,text,631,281,84,20,103_contrasted.png,1024,1448,715,301
1381,text,34,314,152,24,103_contrasted.png,1024,1448,186,338
1382,text,222,312,64,24,103_contrasted.png,1024,1448,286,336
1383,text,514,323,168,23,103_contrasted.png,1024,1448,682,346
1384,text,34,350,160,26,103_contrasted.png,1024,1448,194,376
1385,text,221,351,72,20,103_contrasted.png,1024,1448,293,371
1386,text,513,347,299,24,103_contrasted.png,1024,1448,812,371
1387,text,515,387,120,20,103_contrasted.png,1024,1448,635,407
1388,text,513,407,116,20,103_contrasted.png,1024,1448,629,427
1389,text,31,455,94,18,103_contrasted.png,1024,1448,125,473
1390,text,155,455,40,16,103_contrasted.png,1024,1448,195,471
1391,text,347,453,90,18,103_contrasted.png,1024,1448,437,471
1392,text,547,449,30,20,103_contrasted.png,1024,1448,577,469
1393,text,615,445,67,24,103_contrasted.png,1024,1448,682,469
1394,text,701,449,58,16,103_contrasted.png,1024,1448,759,465
1395,text,785,449,58,16,103_contrasted.png,1024,1448,843,465
1396,text,883,447,84,16,103_contrasted.png,1024,1448,967,463
1397,text,157,471,34,18,103_contrasted.png,1024,1448,191,489
1398,text,781,465,32,18,103_contrasted.png,1024,1448,813,483
1399,text,57,499,30,20,103_contrasted.png,1024,1448,87,519
1400,text,206,492,266,24,103_contrasted.png,1024,1448,472,516
1401,text,528,490,42,24,103_contrasted.png,1024,1448,570,514
1402,text,608,492,54,24,103_contrasted.png,1024,1448,662,516
1403,text,697,491,42,20,103_contrasted.png,1024,1448,739,511
1404,text,776,490,54,24,103_contrasted.png,1024,1448,830,514
1405,text,878,488,54,24,103_contrasted.png,1024,1448,932,512
1406,text,206,514,170,24,103_contrasted.png,1024,1448,376,538
1407,text,682,1044,88,24,103_contrasted.png,1024,1448,770,1068
1408,text,870,1040,56,26,103_contrasted.png,1024,1448,926,1066
1409,text,117,1063,40,16,103_contrasted.png,1024,1448,157,1079
1410,text,177,1063,38,16,103_contrasted.png,1024,1448,215,1079
1411,text,289,1063,38,14,103_contrasted.png,1024,1448,327,1077
1412,text,349,1061,64,16,103_contrasted.png,1024,1448,413,1077
1413,text,682,1076,100,26,103_contrasted.png,1024,1448,782,1102
1414,text,868,1070,58,26,103_contrasted.png,1024,1448,926,1096
1415,text,167,1093,42,20,103_contrasted.png,1024,1448,209,1113
1416,text,279,1095,36,16,103_contrasted.png,1024,1448,315,1111
1417,text,351,1091,42,20,103_contrasted.png,1024,1448,393,1111
1418,text,684,1106,100,26,103_contrasted.png,1024,1448,784,1132
1419,text,872,1102,56,26,103_contrasted.png,1024,1448,928,1128
1420,text,684,1136,85,24,103_contrasted.png,1024,1448,769,1160
1421,text,884,1134,44,24,103_contrasted.png,1024,1448,928,1158
1422,text,119,1153,38,16,103_contrasted.png,1024,1448,157,1169
1423,text,193,1151,42,16,103_contrasted.png,1024,1448,235,1167
1424,text,353,1149,40,16,103_contrasted.png,1024,1448,393,1165
1425,text,192,1175,300,19,103_contrasted.png,1024,1448,492,1194
1426,text,504,1164,299,29,103_contrasted.png,1024,1448,803,1193
1427,text,879,1162,57,22,103_contrasted.png,1024,1448,936,1184
1428,text,54,1197,546,23,103_contrasted.png,1024,1448,600,1220
1429,text,605,1201,70,16,103_contrasted.png,1024,1448,675,1217
1430,text,683,1199,106,18,103_contrasted.png,1024,1448,789,1217
1431,text,800,1201,77,16,103_contrasted.png,1024,1448,877,1217
1432,text,159,1223,72,18,103_contrasted.png,1024,1448,231,1241
1433,text,237,1221,156,18,103_contrasted.png,1024,1448,393,1239
1434,text,399,1223,38,14,103_contrasted.png,1024,1448,437,1237
1435,text,451,1221,296,18,103_contrasted.png,1024,1448,747,1239
1436,text,753,1221,38,14,103_contrasted.png,1024,1448,791,1235
1437,text,797,1221,42,14,103_contrasted.png,1024,1448,839,1235
1438,text,159,1243,200,16,103_contrasted.png,1024,1448,359,1259
1439,text,365,1243,26,14,103_contrasted.png,1024,1448,391,1257
1440,text,395,1241,82,16,103_contrasted.png,1024,1448,477,1257
1441,text,483,1241,134,16,103_contrasted.png,1024,1448,617,1257
1442,text,131,498,18,23,103_contrasted.png,1024,1448,149,521
1443,text,115,1095,18,19,103_contrasted.png,1024,1448,133,1114
1444,text,621,1241,104,15,103_contrasted.png,1024,1448,725,1256
1445,text,732,1242,108,13,103_contrasted.png,1024,1448,840,1255
1446,text,136,40,214,52,103_denoise.png,1024,1448,350,92
1447,text,700,58,232,32,103_denoise.png,1024,1448,932,90
1448,text,245,93,102,14,103_denoise.png,1024,1448,347,107
1449,text,47,177,34,20,103_denoise.png,1024,1448,81,197
1450,text,91,177,142,20,103_denoise.png,1024,1448,233,197
1451,text,620,180,122,24,103_denoise.png,1024,1448,742,204
1452,text,772,179,122,27,103_denoise.png,1024,1448,894,206
1453,text,53,203,64,18,103_denoise.png,1024,1448,117,221
1454,text,249,199,128,20,103_denoise.png,1024,1448,377,219
1455,text,511,239,100,20,103_denoise.png,1024,1448,611,259
1456,text,634,238,140,19,103_denoise.png,1024,1448,774,257
1457,text,513,261,98,20,103_denoise.png,1024,1448,611,281
1458,text,37,281,134,20,103_denoise.png,1024,1448,171,301
1459,text,517,285,88,20,103_denoise.png,1024,1448,605,305
1460,text,631,281,84,20,103_denoise.png,1024,1448,715,301
1461,text,34,314,152,24,103_denoise.png,1024,1448,186,338
1462,text,222,312,64,24,103_denoise.png,1024,1448,286,336
1463,text,514,323,168,23,103_denoise.png,1024,1448,682,346
1464,text,34,350,160,26,103_denoise.png,1024,1448,194,376
1465,text,221,351,72,20,103_denoise.png,1024,1448,293,371
1466,text,513,347,299,24,103_denoise.png,1024,1448,812,371
1467,text,515,387,120,20,103_denoise.png,1024,1448,635,407
1468,text,513,407,116,20,103_denoise.png,1024,1448,629,427
1469,text,31,455,94,18,103_denoise.png,1024,1448,125,473
1470,text,155,455,40,16,103_denoise.png,1024,1448,195,471
1471,text,347,453,90,18,103_denoise.png,1024,1448,437,471
1472,text,547,449,30,20,103_denoise.png,1024,1448,577,469
1473,text,615,445,67,24,103_denoise.png,1024,1448,682,469
1474,text,701,449,58,16,103_denoise.png,1024,1448,759,465
1475,text,785,449,58,16,103_denoise.png,1024,1448,843,465
1476,text,883,447,84,16,103_denoise.png,1024,1448,967,463
1477,text,157,471,34,18,103_denoise.png,1024,1448,191,489
1478,text,781,465,32,18,103_denoise.png,1024,1448,813,483
1479,text,57,499,30,20,103_denoise.png,1024,1448,87,519
1480,text,206,492,266,24,103_denoise.png,1024,1448,472,516
1481,text,528,490,42,24,103_denoise.png,1024,1448,570,514
1482,text,608,492,54,24,103_denoise.png,1024,1448,662,516
1483,text,697,491,42,20,103_denoise.png,1024,1448,739,511
1484,text,776,490,54,24,103_denoise.png,1024,1448,830,514
1485,text,878,488,54,24,103_denoise.png,1024,1448,932,512
1486,text,206,514,170,24,103_denoise.png,1024,1448,376,538
1487,text,682,1044,88,24,103_denoise.png,1024,1448,770,1068
1488,text,870,1040,56,26,103_denoise.png,1024,1448,926,1066
1489,text,117,1063,40,16,103_denoise.png,1024,1448,157,1079
1490,text,177,1063,38,16,103_denoise.png,1024,1448,215,1079
1491,text,289,1063,38,14,103_denoise.png,1024,1448,327,1077
1492,text,349,1061,64,16,103_denoise.png,1024,1448,413,1077
1493,text,682,1076,100,26,103_denoise.png,1024,1448,782,1102
1494,text,868,1070,58,26,103_denoise.png,1024,1448,926,1096
1495,text,167,1093,42,20,103_denoise.png,1024,1448,209,1113
1496,text,279,1095,36,16,103_denoise.png,1024,1448,315,1111
1497,text,351,1091,42,20,103_denoise.png,1024,1448,393,1111
1498,text,684,1106,100,26,103_denoise.png,1024,1448,784,1132
1499,text,872,1102,56,26,103_denoise.png,1024,1448,928,1128
1500,text,684,1136,85,24,103_denoise.png,1024,1448,769,1160
1501,text,884,1134,44,24,103_denoise.png,1024,1448,928,1158
1502,text,119,1153,38,16,103_denoise.png,1024,1448,157,1169
1503,text,193,1151,42,16,103_denoise.png,1024,1448,235,1167
1504,text,353,1149,40,16,103_denoise.png,1024,1448,393,1165
1505,text,192,1175,300,19,103_denoise.png,1024,1448,492,1194
1506,text,504,1164,299,29,103_denoise.png,1024,1448,803,1193
1507,text,879,1162,57,22,103_denoise.png,1024,1448,936,1184
1508,text,54,1197,546,23,103_denoise.png,1024,1448,600,1220
1509,text,605,1201,70,16,103_denoise.png,1024,1448,675,1217
1510,text,683,1199,106,18,103_denoise.png,1024,1448,789,1217
1511,text,800,1201,77,16,103_denoise.png,1024,1448,877,1217
1512,text,159,1223,72,18,103_denoise.png,1024,1448,231,1241
1513,text,237,1221,156,18,103_denoise.png,1024,1448,393,1239
1514,text,399,1223,38,14,103_denoise.png,1024,1448,437,1237
1515,text,451,1221,296,18,103_denoise.png,1024,1448,747,1239
1516,text,753,1221,38,14,103_denoise.png,1024,1448,791,1235
1517,text,797,1221,42,14,103_denoise.png,1024,1448,839,1235
1518,text,159,1243,200,16,103_denoise.png,1024,1448,359,1259
1519,text,365,1243,26,14,103_denoise.png,1024,1448,391,1257
1520,text,395,1241,82,16,103_denoise.png,1024,1448,477,1257
1521,text,483,1241,134,16,103_denoise.png,1024,1448,617,1257
1522,text,131,498,18,23,103_denoise.png,1024,1448,149,521
1523,text,115,1095,18,19,103_denoise.png,1024,1448,133,1114
1524,text,621,1241,104,15,103_denoise.png,1024,1448,725,1256
1525,text,732,1242,108,13,103_denoise.png,1024,1448,840,1255
1526,text,136,40,214,52,103_median.png,1024,1448,350,92
1527,text,700,58,232,32,103_median.png,1024,1448,932,90
1528,text,245,93,102,14,103_median.png,1024,1448,347,107
1529,text,47,177,34,20,103_median.png,1024,1448,81,197
1530,text,91,177,142,20,103_median.png,1024,1448,233,197
1531,text,620,180,122,24,103_median.png,1024,1448,742,204
1532,text,772,179,122,27,103_median.png,1024,1448,894,206
1533,text,53,203,64,18,103_median.png,1024,1448,117,221
1534,text,249,199,128,20,103_median.png,1024,1448,377,219
1535,text,511,239,100,20,103_median.png,1024,1448,611,259
1536,text,634,238,140,19,103_median.png,1024,1448,774,257
1537,text,513,261,98,20,103_median.png,1024,1448,611,281
1538,text,37,281,134,20,103_median.png,1024,1448,171,301
1539,text,517,285,88,20,103_median.png,1024,1448,605,305
1540,text,631,281,84,20,103_median.png,1024,1448,715,301
1541,text,34,314,152,24,103_median.png,1024,1448,186,338
1542,text,222,312,64,24,103_median.png,1024,1448,286,336
1543,text,514,323,168,23,103_median.png,1024,1448,682,346
1544,text,34,350,160,26,103_median.png,1024,1448,194,376
1545,text,221,351,72,20,103_median.png,1024,1448,293,371
1546,text,513,347,299,24,103_median.png,1024,1448,812,371
1547,text,515,387,120,20,103_median.png,1024,1448,635,407
1548,text,513,407,116,20,103_median.png,1024,1448,629,427
1549,text,31,455,94,18,103_median.png,1024,1448,125,473
1550,text,155,455,40,16,103_median.png,1024,1448,195,471
1551,text,347,453,90,18,103_median.png,1024,1448,437,471
1552,text,547,449,30,20,103_median.png,1024,1448,577,469
1553,text,615,445,67,24,103_median.png,1024,1448,682,469
1554,text,701,449,58,16,103_median.png,1024,1448,759,465
1555,text,785,449,58,16,103_median.png,1024,1448,843,465
1556,text,883,447,84,16,103_median.png,1024,1448,967,463
1557,text,157,471,34,18,103_median.png,1024,1448,191,489
1558,text,781,465,32,18,103_median.png,1024,1448,813,483
1559,text,57,499,30,20,103_median.png,1024,1448,87,519
1560,text,206,492,266,24,103_median.png,1024,1448,472,516
1561,text,528,490,42,24,103_median.png,1024,1448,570,514
1562,text,608,492,54,24,103_median.png,1024,1448,662,516
1563,text,697,491,42,20,103_median.png,1024,1448,739,511
1564,text,776,490,54,24,103_median.png,1024,1448,830,514
1565,text,878,488,54,24,103_median.png,1024,1448,932,512
1566,text,206,514,170,24,103_median.png,1024,1448,376,538
1567,text,682,1044,88,24,103_median.png,1024,1448,770,1068
1568,text,870,1040,56,26,103_median.png,1024,1448,926,1066
1569,text,117,1063,40,16,103_median.png,1024,1448,157,1079
1570,text,177,1063,38,16,103_median.png,1024,1448,215,1079
1571,text,289,1063,38,14,103_median.png,1024,1448,327,1077
1572,text,349,1061,64,16,103_median.png,1024,1448,413,1077
1573,text,682,1076,100,26,103_median.png,1024,1448,782,1102
1574,text,868,1070,58,26,103_median.png,1024,1448,926,1096
1575,text,167,1093,42,20,103_median.png,1024,1448,209,1113
1576,text,279,1095,36,16,103_median.png,1024,1448,315,1111
1577,text,351,1091,42,20,103_median.png,1024,1448,393,1111
1578,text,684,1106,100,26,103_median.png,1024,1448,784,1132
1579,text,872,1102,56,26,103_median.png,1024,1448,928,1128
1580,text,684,1136,85,24,103_median.png,1024,1448,769,1160
1581,text,884,1134,44,24,103_median.png,1024,1448,928,1158
1582,text,119,1153,38,16,103_median.png,1024,1448,157,1169
1583,text,193,1151,42,16,103_median.png,1024,1448,235,1167
1584,text,353,1149,40,16,103_median.png,1024,1448,393,1165
1585,text,192,1175,300,19,103_median.png,1024,1448,492,1194
1586,text,504,1164,299,29,103_median.png,1024,1448,803,1193
1587,text,879,1162,57,22,103_median.png,1024,1448,936,1184
1588,text,54,1197,546,23,103_median.png,1024,1448,600,1220
1589,text,605,1201,70,16,103_median.png,1024,1448,675,1217
1590,text,683,1199,106,18,103_median.png,1024,1448,789,1217
1591,text,800,1201,77,16,103_median.png,1024,1448,877,1217
1592,text,159,1223,72,18,103_median.png,1024,1448,231,1241
1593,text,237,1221,156,18,103_median.png,1024,1448,393,1239
1594,text,399,1223,38,14,103_median.png,1024,1448,437,1237
1595,text,451,1221,296,18,103_median.png,1024,1448,747,1239
1596,text,753,1221,38,14,103_median.png,1024,1448,791,1235
1597,text,797,1221,42,14,103_median.png,1024,1448,839,1235
1598,text,159,1243,200,16,103_median.png,1024,1448,359,1259
1599,text,365,1243,26,14,103_median.png,1024,1448,391,1257
1600,text,395,1241,82,16,103_median.png,1024,1448,477,1257
1601,text,483,1241,134,16,103_median.png,1024,1448,617,1257
1602,text,131,498,18,23,103_median.png,1024,1448,149,521
1603,text,115,1095,18,19,103_median.png,1024,1448,133,1114
1604,text,621,1241,104,15,103_median.png,1024,1448,725,1256
1605,text,732,1242,108,13,103_median.png,1024,1448,840,1255
1606,text,52,58,228,50,10_contrasted.png,1024,1448,280,108
1607,text,122,174,142,26,10_contrasted.png,1024,1448,264,200
1608,text,279,174,132,25,10_contrasted.png,1024,1448,411,199
1609,text,555,177,114,20,10_contrasted.png,1024,1448,669,197
1610,text,554,214,342,17,10_contrasted.png,1024,1448,896,231
1611,text,554,232,364,19,10_contrasted.png,1024,1448,918,251
1612,text,555,251,106,18,10_contrasted.png,1024,1448,661,269
1613,text,673,250,62,20,10_contrasted.png,1024,1448,735,270
1614,text,553,270,138,17,10_contrasted.png,1024,1448,691,287
1615,text,557,293,181,17,10_contrasted.png,1024,1448,738,310
1616,text,699,322,241,26,10_contrasted.png,1024,1448,940,348
1617,text,34,346,107,29,10_contrasted.png,1024,1448,141,375
1618,text,177,351,70,20,10_contrasted.png,1024,1448,247,371
1619,text,79,403,106,20,10_contrasted.png,1024,1448,185,423
1620,text,354,402,108,24,10_contrasted.png,1024,1448,462,426
1621,text,596,400,38,24,10_contrasted.png,1024,1448,634,424
1622,text,679,401,34,20,10_contrasted.png,1024,1448,713,421
1623,text,813,399,78,20,10_contrasted.png,1024,1448,891,419
1624,text,267,433,148,20,10_contrasted.png,1024,1448,415,453
1625,text,420,431,128,20,10_contrasted.png,1024,1448,548,451
1626,text,27,459,66,20,10_contrasted.png,1024,1448,93,479
1627,text,234,456,286,24,10_contrasted.png,1024,1448,520,480
1628,text,591,457,38,20,10_contrasted.png,1024,1448,629,477
1629,text,673,455,58,20,10_contrasted.png,1024,1448,731,475
1630,text,819,453,60,20,10_contrasted.png,1024,1448,879,473
1631,text,236,478,188,24,10_contrasted.png,1024,1448,424,502
1632,text,55,505,114,20,10_contrasted.png,1024,1448,169,525
1633,text,234,501,284,27,10_contrasted.png,1024,1448,518,528
1634,text,523,507,32,16,10_contrasted.png,1024,1448,555,523
1635,text,591,503,38,20,10_contrasted.png,1024,1448,629,523
1636,text,671,503,60,20,10_contrasted.png,1024,1448,731,523
1637,text,819,501,58,20,10_contrasted.png,1024,1448,877,521
1638,text,46,1046,72,24,10_contrasted.png,1024,1448,118,1070
1639,text,143,1047,26,20,10_contrasted.png,1024,1448,169,1067
1640,text,205,1047,70,20,10_contrasted.png,1024,1448,275,1067
1641,text,619,1041,100,20,10_contrasted.png,1024,1448,719,1061
1642,text,800,1038,72,25,10_contrasted.png,1024,1448,872,1063
1643,text,609,1071,112,20,10_contrasted.png,1024,1448,721,1091
1644,text,800,1068,72,24,10_contrasted.png,1024,1448,872,1092
1645,text,613,1101,110,20,10_contrasted.png,1024,1448,723,1121
1646,text,800,1098,72,24,10_contrasted.png,1024,1448,872,1122
1647,text,26,1138,372,26,10_contrasted.png,1024,1448,398,1164
1648,text,500,1134,190,26,10_contrasted.png,1024,1448,690,1160
1649,text,34,1170,246,24,10_contrasted.png,1024,1448,280,1194
1650,text,500,1160,322,24,10_contrasted.png,1024,1448,822,1184
1651,text,16,1319,360,20,10_contrasted.png,1024,1448,376,1339
1652,text,651,1315,104,20,10_contrasted.png,1024,1448,755,1335
1653,text,767,1315,140,20,10_contrasted.png,1024,1448,907,1335
1654,text,97,1339,118,18,10_contrasted.png,1024,1448,215,1357
1655,text,221,1337,144,20,10_contrasted.png,1024,1448,365,1357
1656,text,371,1337,102,20,10_contrasted.png,1024,1448,473,1357
1657,text,479,1337,138,18,10_contrasted.png,1024,1448,617,1355
1658,text,624,1335,204,18,10_contrasted.png,1024,1448,828,1353
1659,text,356,1356,220,21,10_contrasted.png,1024,1448,576,1377
1660,text,388,1318,106,20,10_contrasted.png,1024,1448,494,1338
1661,text,498,1319,140,16,10_contrasted.png,1024,1448,638,1335
1662,text,52,58,228,50,10_denoise.png,1024,1448,280,108
1663,text,122,174,142,26,10_denoise.png,1024,1448,264,200
1664,text,279,174,132,25,10_denoise.png,1024,1448,411,199
1665,text,555,177,114,20,10_denoise.png,1024,1448,669,197
1666,text,554,214,342,17,10_denoise.png,1024,1448,896,231
1667,text,554,232,364,19,10_denoise.png,1024,1448,918,251
1668,text,555,251,106,18,10_denoise.png,1024,1448,661,269
1669,text,673,250,62,20,10_denoise.png,1024,1448,735,270
1670,text,553,270,138,17,10_denoise.png,1024,1448,691,287
1671,text,557,293,181,17,10_denoise.png,1024,1448,738,310
1672,text,699,322,241,26,10_denoise.png,1024,1448,940,348
1673,text,34,346,107,29,10_denoise.png,1024,1448,141,375
1674,text,177,351,70,20,10_denoise.png,1024,1448,247,371
1675,text,79,403,106,20,10_denoise.png,1024,1448,185,423
1676,text,354,402,108,24,10_denoise.png,1024,1448,462,426
1677,text,596,400,38,24,10_denoise.png,1024,1448,634,424
1678,text,679,401,34,20,10_denoise.png,1024,1448,713,421
1679,text,813,399,78,20,10_denoise.png,1024,1448,891,419
1680,text,267,433,148,20,10_denoise.png,1024,1448,415,453
1681,text,420,431,128,20,10_denoise.png,1024,1448,548,451
1682,text,27,459,66,20,10_denoise.png,1024,1448,93,479
1683,text,234,456,286,24,10_denoise.png,1024,1448,520,480
1684,text,591,457,38,20,10_denoise.png,1024,1448,629,477
1685,text,673,455,58,20,10_denoise.png,1024,1448,731,475
1686,text,819,453,60,20,10_denoise.png,1024,1448,879,473
1687,text,236,478,188,24,10_denoise.png,1024,1448,424,502
1688,text,55,505,114,20,10_denoise.png,1024,1448,169,525
1689,text,234,501,284,27,10_denoise.png,1024,1448,518,528
1690,text,523,507,32,16,10_denoise.png,1024,1448,555,523
1691,text,591,503,38,20,10_denoise.png,1024,1448,629,523
1692,text,671,503,60,20,10_denoise.png,1024,1448,731,523
1693,text,819,501,58,20,10_denoise.png,1024,1448,877,521
1694,text,46,1046,72,24,10_denoise.png,1024,1448,118,1070
1695,text,143,1047,26,20,10_denoise.png,1024,1448,169,1067
1696,text,205,1047,70,20,10_denoise.png,1024,1448,275,1067
1697,text,619,1041,100,20,10_denoise.png,1024,1448,719,1061
1698,text,800,1038,72,25,10_denoise.png,1024,1448,872,1063
1699,text,609,1071,112,20,10_denoise.png,1024,1448,721,1091
1700,text,800,1068,72,24,10_denoise.png,1024,1448,872,1092
1701,text,613,1101,110,20,10_denoise.png,1024,1448,723,1121
1702,text,800,1098,72,24,10_denoise.png,1024,1448,872,1122
1703,text,26,1138,372,26,10_denoise.png,1024,1448,398,1164
1704,text,500,1134,190,26,10_denoise.png,1024,1448,690,1160
1705,text,34,1170,246,24,10_denoise.png,1024,1448,280,1194
1706,text,16,1319,360,20,10_denoise.png,1024,1448,376,1339
1707,text,651,1315,104,20,10_denoise.png,1024,1448,755,1335
1708,text,767,1315,140,20,10_denoise.png,1024,1448,907,1335
1709,text,97,1339,118,18,10_denoise.png,1024,1448,215,1357
1710,text,221,1337,144,20,10_denoise.png,1024,1448,365,1357
1711,text,371,1337,102,20,10_denoise.png,1024,1448,473,1357
1712,text,479,1337,138,18,10_denoise.png,1024,1448,617,1355
1713,text,624,1335,204,18,10_denoise.png,1024,1448,828,1353
1714,text,356,1356,220,21,10_denoise.png,1024,1448,576,1377
1715,text,388,1318,106,20,10_denoise.png,1024,1448,494,1338
1716,text,498,1319,140,16,10_denoise.png,1024,1448,638,1335
1717,text,52,58,228,50,10_median.png,1024,1448,280,108
1718,text,122,174,142,26,10_median.png,1024,1448,264,200
1719,text,279,174,132,25,10_median.png,1024,1448,411,199
1720,text,555,177,114,20,10_median.png,1024,1448,669,197
1721,text,554,214,342,17,10_median.png,1024,1448,896,231
1722,text,554,232,364,19,10_median.png,1024,1448,918,251
1723,text,555,251,106,18,10_median.png,1024,1448,661,269
1724,text,673,250,62,20,10_median.png,1024,1448,735,270
1725,text,553,270,138,17,10_median.png,1024,1448,691,287
1726,text,557,293,181,17,10_median.png,1024,1448,738,310
1727,text,699,322,241,26,10_median.png,1024,1448,940,348
1728,text,34,346,107,29,10_median.png,1024,1448,141,375
1729,text,177,351,70,20,10_median.png,1024,1448,247,371
1730,text,79,403,106,20,10_median.png,1024,1448,185,423
1731,text,354,402,108,24,10_median.png,1024,1448,462,426
1732,text,596,400,38,24,10_median.png,1024,1448,634,424
1733,text,679,401,34,20,10_median.png,1024,1448,713,421
1734,text,813,399,78,20,10_median.png,1024,1448,891,419
1735,text,267,433,148,20,10_median.png,1024,1448,415,453
1736,text,420,431,128,20,10_median.png,1024,1448,548,451
1737,text,27,459,66,20,10_median.png,1024,1448,93,479
1738,text,234,456,286,24,10_median.png,1024,1448,520,480
1739,text,591,457,38,20,10_median.png,1024,1448,629,477
1740,text,673,455,58,20,10_median.png,1024,1448,731,475
1741,text,819,453,60,20,10_median.png,1024,1448,879,473
1742,text,236,478,188,24,10_median.png,1024,1448,424,502
1743,text,55,505,114,20,10_median.png,1024,1448,169,525
1744,text,234,501,284,27,10_median.png,1024,1448,518,528
1745,text,523,507,32,16,10_median.png,1024,1448,555,523
1746,text,591,503,38,20,10_median.png,1024,1448,629,523
1747,text,671,503,60,20,10_median.png,1024,1448,731,523
1748,text,819,501,58,20,10_median.png,1024,1448,877,521
1749,text,46,1046,72,24,10_median.png,1024,1448,118,1070
1750,text,143,1047,26,20,10_median.png,1024,1448,169,1067
1751,text,205,1047,70,20,10_median.png,1024,1448,275,1067
1752,text,619,1041,100,20,10_median.png,1024,1448,719,1061
1753,text,800,1038,72,25,10_median.png,1024,1448,872,1063
1754,text,609,1071,112,20,10_median.png,1024,1448,721,1091
1755,text,800,1068,72,24,10_median.png,1024,1448,872,1092
1756,text,613,1101,110,20,10_median.png,1024,1448,723,1121
1757,text,800,1098,72,24,10_median.png,1024,1448,872,1122
1758,text,26,1138,372,26,10_median.png,1024,1448,398,1164
1759,text,500,1134,190,26,10_median.png,1024,1448,690,1160
1760,text,34,1170,246,24,10_median.png,1024,1448,280,1194
1761,text,500,1160,322,24,10_median.png,1024,1448,822,1184
1762,text,16,1319,360,20,10_median.png,1024,1448,376,1339
1763,text,651,1315,104,20,10_median.png,1024,1448,755,1335
1764,text,767,1315,140,20,10_median.png,1024,1448,907,1335
1765,text,97,1339,118,18,10_median.png,1024,1448,215,1357
1766,text,221,1337,144,20,10_median.png,1024,1448,365,1357
1767,text,371,1337,102,20,10_median.png,1024,1448,473,1357
1768,text,479,1337,138,18,10_median.png,1024,1448,617,1355
1769,text,624,1335,204,18,10_median.png,1024,1448,828,1353
1770,text,356,1356,220,21,10_median.png,1024,1448,576,1377
1771,text,388,1318,106,20,10_median.png,1024,1448,494,1338
1772,text,498,1319,140,16,10_median.png,1024,1448,638,1335
1773,text,860,94,82,24,11.png,1024,1430,942,118
1774,text,795,117,32,18,11.png,1024,1430,827,135
1775,text,839,115,102,20,11.png,1024,1430,941,135
1776,text,85,107,381,66,11.png,1024,1430,466,173
1777,text,773,141,94,14,11.png,1024,1430,867,155
1778,text,873,141,68,14,11.png,1024,1430,941,155
1779,text,777,155,90,14,11.png,1024,1430,867,169
1780,text,873,153,68,16,11.png,1024,1430,941,169
1781,text,101,169,92,12,11.png,1024,1430,193,181
1782,text,303,169,108,12,11.png,1024,1430,411,181
1783,text,821,167,70,16,11.png,1024,1430,891,183
1784,text,897,167,44,16,11.png,1024,1430,941,183
1785,text,87,217,60,16,11.png,1024,1430,147,233
1786,text,501,217,66,16,11.png,1024,1430,567,233
1787,text,95,253,136,20,11.png,1024,1430,231,273
1788,text,501,251,142,20,11.png,1024,1430,643,271
1789,text,97,275,34,16,11.png,1024,1430,131,291
1790,text,135,274,77,17,11.png,1024,1430,212,291
1791,text,219,273,180,18,11.png,1024,1430,399,291
1792,text,500,270,328,20,11.png,1024,1430,828,290
1793,text,93,291,136,18,11.png,1024,1430,229,309
1794,text,499,289,147,19,11.png,1024,1430,646,308
1795,text,502,307,99,20,11.png,1024,1430,601,327
1796,text,93,325,168,20,11.png,1024,1430,261,345
1797,text,95,347,190,16,11.png,1024,1430,285,363
1798,text,95,365,194,16,11.png,1024,1430,289,381
1799,text,85,447,60,14,11.png,1024,1430,145,461
1800,text,83,479,90,20,11.png,1024,1430,173,499
1801,text,759,507,180,16,11.png,1024,1430,939,523
1802,text,85,531,78,18,11.png,1024,1430,163,549
1803,text,603,529,32,18,11.png,1024,1430,635,547
1804,text,667,531,54,16,11.png,1024,1430,721,547
1805,text,761,529,28,18,11.png,1024,1430,789,547
1806,text,857,531,58,16,11.png,1024,1430,915,547
1807,text,83,555,130,20,11.png,1024,1430,213,575
1808,text,237,555,354,20,11.png,1024,1430,591,575
1809,text,619,557,32,18,11.png,1024,1430,651,575
1810,text,676,557,63,18,11.png,1024,1430,739,575
1811,text,869,559,68,16,11.png,1024,1430,937,575
1812,text,83,575,104,18,11.png,1024,1430,187,593
1813,text,81,1073,156,16,11.png,1024,1430,237,1089
1814,text,269,1073,68,16,11.png,1024,1430,337,1089
1815,text,575,1073,58,16,11.png,1024,1430,633,1089
1816,text,860,1070,71,19,11.png,1024,1430,931,1089
1817,text,575,1089,100,18,11.png,1024,1430,675,1107
1818,text,861,1089,70,18,11.png,1024,1430,931,1107
1819,text,79,1100,361,19,11.png,1024,1430,440,1119
1820,text,575,1107,66,18,11.png,1024,1430,641,1125
1821,text,861,1107,70,18,11.png,1024,1430,931,1125
1822,text,75,1121,240,16,11.png,1024,1430,315,1137
1823,text,79,1137,106,14,11.png,1024,1430,185,1151
1824,text,73,1312,484,15,11.png,1024,1430,557,1327
1825,text,357,1331,61,14,11.png,1024,1430,418,1345
1826,text,420,1331,123,14,11.png,1024,1430,543,1345
1827,text,549,1331,98,14,11.png,1024,1430,647,1345
1828,text,413,1345,76,14,11.png,1024,1430,489,1359
1829,text,495,1345,95,14,11.png,1024,1430,590,1359
1830,text,791,557,26,21,11.png,1024,1430,817,578
1831,text,897,1344,21,17,11.png,1024,1430,918,1361
1832,text,860,94,82,24,11_contrasted.png,1024,1430,942,118
1833,text,795,117,32,18,11_contrasted.png,1024,1430,827,135
1834,text,839,115,102,20,11_contrasted.png,1024,1430,941,135
1835,text,773,141,94,14,11_contrasted.png,1024,1430,867,155
1836,text,873,141,68,14,11_contrasted.png,1024,1430,941,155
1837,text,777,155,90,14,11_contrasted.png,1024,1430,867,169
1838,text,873,153,68,16,11_contrasted.png,1024,1430,941,169
1839,text,101,169,92,12,11_contrasted.png,1024,1430,193,181
1840,text,303,169,108,12,11_contrasted.png,1024,1430,411,181
1841,text,821,167,70,16,11_contrasted.png,1024,1430,891,183
1842,text,897,167,44,16,11_contrasted.png,1024,1430,941,183
1843,text,87,217,60,16,11_contrasted.png,1024,1430,147,233
1844,text,501,217,66,16,11_contrasted.png,1024,1430,567,233
1845,text,95,253,136,20,11_contrasted.png,1024,1430,231,273
1846,text,501,251,142,20,11_contrasted.png,1024,1430,643,271
1847,text,97,275,34,16,11_contrasted.png,1024,1430,131,291
1848,text,135,274,77,17,11_contrasted.png,1024,1430,212,291
1849,text,219,273,180,18,11_contrasted.png,1024,1430,399,291
1850,text,500,270,328,20,11_contrasted.png,1024,1430,828,290
1851,text,93,291,136,18,11_contrasted.png,1024,1430,229,309
1852,text,499,289,147,19,11_contrasted.png,1024,1430,646,308
1853,text,502,307,99,20,11_contrasted.png,1024,1430,601,327
1854,text,93,325,168,20,11_contrasted.png,1024,1430,261,345
1855,text,95,347,190,16,11_contrasted.png,1024,1430,285,363
1856,text,95,365,194,16,11_contrasted.png,1024,1430,289,381
1857,text,85,447,60,14,11_contrasted.png,1024,1430,145,461
1858,text,83,479,90,20,11_contrasted.png,1024,1430,173,499
1859,text,759,507,180,16,11_contrasted.png,1024,1430,939,523
1860,text,85,531,78,18,11_contrasted.png,1024,1430,163,549
1861,text,603,529,32,18,11_contrasted.png,1024,1430,635,547
1862,text,667,531,54,16,11_contrasted.png,1024,1430,721,547
1863,text,761,529,28,18,11_contrasted.png,1024,1430,789,547
1864,text,857,531,58,16,11_contrasted.png,1024,1430,915,547
1865,text,83,555,130,20,11_contrasted.png,1024,1430,213,575
1866,text,237,555,354,20,11_contrasted.png,1024,1430,591,575
1867,text,619,557,32,18,11_contrasted.png,1024,1430,651,575
1868,text,676,557,63,18,11_contrasted.png,1024,1430,739,575
1869,text,869,559,68,16,11_contrasted.png,1024,1430,937,575
1870,text,83,575,104,18,11_contrasted.png,1024,1430,187,593
1871,text,81,1073,156,16,11_contrasted.png,1024,1430,237,1089
1872,text,269,1073,68,16,11_contrasted.png,1024,1430,337,1089
1873,text,575,1073,58,16,11_contrasted.png,1024,1430,633,1089
1874,text,860,1070,71,19,11_contrasted.png,1024,1430,931,1089
1875,text,575,1089,100,18,11_contrasted.png,1024,1430,675,1107
1876,text,861,1089,70,18,11_contrasted.png,1024,1430,931,1107
1877,text,79,1100,361,19,11_contrasted.png,1024,1430,440,1119
1878,text,575,1107,66,18,11_contrasted.png,1024,1430,641,1125
1879,text,861,1107,70,18,11_contrasted.png,1024,1430,931,1125
1880,text,75,1121,240,16,11_contrasted.png,1024,1430,315,1137
1881,text,79,1137,106,14,11_contrasted.png,1024,1430,185,1151
1882,text,73,1312,484,15,11_contrasted.png,1024,1430,557,1327
1883,text,357,1331,61,14,11_contrasted.png,1024,1430,418,1345
1884,text,420,1331,123,14,11_contrasted.png,1024,1430,543,1345
1885,text,549,1331,98,14,11_contrasted.png,1024,1430,647,1345
1886,text,413,1345,76,14,11_contrasted.png,1024,1430,489,1359
1887,text,495,1345,95,14,11_contrasted.png,1024,1430,590,1359
1888,text,791,557,26,21,11_contrasted.png,1024,1430,817,578
1889,text,897,1344,21,17,11_contrasted.png,1024,1430,918,1361
1890,text,860,94,82,24,11_denoise.png,1024,1430,942,118
1891,text,795,117,32,18,11_denoise.png,1024,1430,827,135
1892,text,839,115,102,20,11_denoise.png,1024,1430,941,135
1893,text,85,107,381,66,11_denoise.png,1024,1430,466,173
1894,text,773,141,94,14,11_denoise.png,1024,1430,867,155
1895,text,873,141,68,14,11_denoise.png,1024,1430,941,155
1896,text,777,155,90,14,11_denoise.png,1024,1430,867,169
1897,text,873,153,68,16,11_denoise.png,1024,1430,941,169
1898,text,101,169,92,12,11_denoise.png,1024,1430,193,181
1899,text,303,169,108,12,11_denoise.png,1024,1430,411,181
1900,text,821,167,70,16,11_denoise.png,1024,1430,891,183
1901,text,897,167,44,16,11_denoise.png,1024,1430,941,183
1902,text,87,217,60,16,11_denoise.png,1024,1430,147,233
1903,text,501,217,66,16,11_denoise.png,1024,1430,567,233
1904,text,95,253,136,20,11_denoise.png,1024,1430,231,273
1905,text,501,251,142,20,11_denoise.png,1024,1430,643,271
1906,text,97,275,34,16,11_denoise.png,1024,1430,131,291
1907,text,135,274,77,17,11_denoise.png,1024,1430,212,291
1908,text,219,273,180,18,11_denoise.png,1024,1430,399,291
1909,text,500,270,328,20,11_denoise.png,1024,1430,828,290
1910,text,93,291,136,18,11_denoise.png,1024,1430,229,309
1911,text,499,289,147,19,11_denoise.png,1024,1430,646,308
1912,text,502,307,99,20,11_denoise.png,1024,1430,601,327
1913,text,93,325,168,20,11_denoise.png,1024,1430,261,345
1914,text,95,347,190,16,11_denoise.png,1024,1430,285,363
1915,text,95,365,194,16,11_denoise.png,1024,1430,289,381
1916,text,85,447,60,14,11_denoise.png,1024,1430,145,461
1917,text,83,479,90,20,11_denoise.png,1024,1430,173,499
1918,text,759,507,180,16,11_denoise.png,1024,1430,939,523
1919,text,85,531,78,18,11_denoise.png,1024,1430,163,549
1920,text,603,529,32,18,11_denoise.png,1024,1430,635,547
1921,text,667,531,54,16,11_denoise.png,1024,1430,721,547
1922,text,761,529,28,18,11_denoise.png,1024,1430,789,547
1923,text,857,531,58,16,11_denoise.png,1024,1430,915,547
1924,text,83,555,130,20,11_denoise.png,1024,1430,213,575
1925,text,237,555,354,20,11_denoise.png,1024,1430,591,575
1926,text,619,557,32,18,11_denoise.png,1024,1430,651,575
1927,text,676,557,63,18,11_denoise.png,1024,1430,739,575
1928,text,869,559,68,16,11_denoise.png,1024,1430,937,575
1929,text,83,575,104,18,11_denoise.png,1024,1430,187,593
1930,text,81,1073,156,16,11_denoise.png,1024,1430,237,1089
1931,text,269,1073,68,16,11_denoise.png,1024,1430,337,1089
1932,text,575,1073,58,16,11_denoise.png,1024,1430,633,1089
1933,text,860,1070,71,19,11_denoise.png,1024,1430,931,1089
1934,text,575,1089,100,18,11_denoise.png,1024,1430,675,1107
1935,text,861,1089,70,18,11_denoise.png,1024,1430,931,1107
1936,text,79,1100,361,19,11_denoise.png,1024,1430,440,1119
1937,text,575,1107,66,18,11_denoise.png,1024,1430,641,1125
1938,text,861,1107,70,18,11_denoise.png,1024,1430,931,1125
1939,text,75,1121,240,16,11_denoise.png,1024,1430,315,1137
1940,text,79,1137,106,14,11_denoise.png,1024,1430,185,1151
1941,text,73,1312,484,15,11_denoise.png,1024,1430,557,1327
1942,text,357,1331,61,14,11_denoise.png,1024,1430,418,1345
1943,text,420,1331,123,14,11_denoise.png,1024,1430,543,1345
1944,text,549,1331,98,14,11_denoise.png,1024,1430,647,1345
1945,text,413,1345,76,14,11_denoise.png,1024,1430,489,1359
1946,text,495,1345,95,14,11_denoise.png,1024,1430,590,1359
1947,text,791,557,26,21,11_denoise.png,1024,1430,817,578
1948,text,897,1344,21,17,11_denoise.png,1024,1430,918,1361
1949,text,860,94,82,24,11_median.png,1024,1430,942,118
1950,text,795,117,32,18,11_median.png,1024,1430,827,135
1951,text,839,115,102,20,11_median.png,1024,1430,941,135
1952,text,85,107,381,66,11_median.png,1024,1430,466,173
1953,text,773,141,94,14,11_median.png,1024,1430,867,155
1954,text,873,141,68,14,11_median.png,1024,1430,941,155
1955,text,777,155,90,14,11_median.png,1024,1430,867,169
1956,text,873,153,68,16,11_median.png,1024,1430,941,169
1957,text,101,169,92,12,11_median.png,1024,1430,193,181
1958,text,303,169,108,12,11_median.png,1024,1430,411,181
1959,text,821,167,70,16,11_median.png,1024,1430,891,183
1960,text,897,167,44,16,11_median.png,1024,1430,941,183
1961,text,87,217,60,16,11_median.png,1024,1430,147,233
1962,text,501,217,66,16,11_median.png,1024,1430,567,233
1963,text,95,253,136,20,11_median.png,1024,1430,231,273
1964,text,501,251,142,20,11_median.png,1024,1430,643,271
1965,text,97,275,34,16,11_median.png,1024,1430,131,291
1966,text,135,274,77,17,11_median.png,1024,1430,212,291
1967,text,219,273,180,18,11_median.png,1024,1430,399,291
1968,text,500,270,328,20,11_median.png,1024,1430,828,290
1969,text,93,291,136,18,11_median.png,1024,1430,229,309
1970,text,499,289,147,19,11_median.png,1024,1430,646,308
1971,text,502,307,99,20,11_median.png,1024,1430,601,327
1972,text,93,325,168,20,11_median.png,1024,1430,261,345
1973,text,95,347,190,16,11_median.png,1024,1430,285,363
1974,text,95,365,194,16,11_median.png,1024,1430,289,381
1975,text,85,447,60,14,11_median.png,1024,1430,145,461
1976,text,83,479,90,20,11_median.png,1024,1430,173,499
1977,text,759,507,180,16,11_median.png,1024,1430,939,523
1978,text,85,531,78,18,11_median.png,1024,1430,163,549
1979,text,603,529,32,18,11_median.png,1024,1430,635,547
1980,text,667,531,54,16,11_median.png,1024,1430,721,547
1981,text,761,529,28,18,11_median.png,1024,1430,789,547
1982,text,857,531,58,16,11_median.png,1024,1430,915,547
1983,text,83,555,130,20,11_median.png,1024,1430,213,575
1984,text,237,555,354,20,11_median.png,1024,1430,591,575
1985,text,619,557,32,18,11_median.png,1024,1430,651,575
1986,text,676,557,63,18,11_median.png,1024,1430,739,575
1987,text,869,559,68,16,11_median.png,1024,1430,937,575
1988,text,83,575,104,18,11_median.png,1024,1430,187,593
1989,text,81,1073,156,16,11_median.png,1024,1430,237,1089
1990,text,269,1073,68,16,11_median.png,1024,1430,337,1089
1991,text,575,1073,58,16,11_median.png,1024,1430,633,1089
1992,text,860,1070,71,19,11_median.png,1024,1430,931,1089
1993,text,575,1089,100,18,11_median.png,1024,1430,675,1107
1994,text,861,1089,70,18,11_median.png,1024,1430,931,1107
1995,text,79,1100,361,19,11_median.png,1024,1430,440,1119
1996,text,575,1107,66,18,11_median.png,1024,1430,641,1125
1997,text,861,1107,70,18,11_median.png,1024,1430,931,1125
1998,text,75,1121,240,16,11_median.png,1024,1430,315,1137
1999,text,79,1137,106,14,11_median.png,1024,1430,185,1151
2000,text,73,1312,484,15,11_median.png,1024,1430,557,1327
2001,text,357,1331,61,14,11_median.png,1024,1430,418,1345
2002,text,420,1331,123,14,11_median.png,1024,1430,543,1345
2003,text,549,1331,98,14,11_median.png,1024,1430,647,1345
2004,text,413,1345,76,14,11_median.png,1024,1430,489,1359
2005,text,495,1345,95,14,11_median.png,1024,1430,590,1359
2006,text,791,557,26,21,11_median.png,1024,1430,817,578
2007,text,897,1344,21,17,11_median.png,1024,1430,918,1361
2008,text,265,41,462,44,12.png,1024,1448,727,85
2009,text,411,85,172,20,12.png,1024,1448,583,105
2010,text,283,101,216,18,12.png,1024,1448,499,119
2011,text,507,103,198,18,12.png,1024,1448,705,121
2012,text,253,117,30,18,12.png,1024,1448,283,135
2013,text,291,117,206,20,12.png,1024,1448,497,137
2014,text,505,119,91,18,12.png,1024,1448,596,137
2015,text,600,119,137,18,12.png,1024,1448,737,137
2016,text,187,135,46,16,12.png,1024,1448,233,151
2017,text,245,137,166,16,12.png,1024,1448,411,153
2018,text,419,135,386,21,12.png,1024,1448,805,156
2019,text,155,153,72,16,12.png,1024,1448,227,169
2020,text,237,153,40,16,12.png,1024,1448,277,169
2021,text,287,153,76,16,12.png,1024,1448,363,169
2022,text,373,153,58,18,12.png,1024,1448,431,171
2023,text,437,153,40,16,12.png,1024,1448,477,169
2024,text,485,153,64,18,12.png,1024,1448,549,171
2025,text,559,155,52,16,12.png,1024,1448,611,171
2026,text,619,155,66,16,12.png,1024,1448,685,171
2027,text,691,154,143,17,12.png,1024,1448,834,171
2028,text,629,195,121,26,12.png,1024,1448,750,221
2029,text,758,196,90,24,12.png,1024,1448,848,220
2030,text,56,216,152,28,12.png,1024,1448,208,244
2031,text,224,216,126,28,12.png,1024,1448,350,244
2032,text,49,253,70,20,12.png,1024,1448,119,273
2033,text,513,255,72,20,12.png,1024,1448,585,275
2034,text,49,279,48,20,12.png,1024,1448,97,299
2035,text,235,279,42,20,12.png,1024,1448,277,299
2036,text,47,305,134,18,12.png,1024,1448,181,323
2037,text,235,307,98,16,12.png,1024,1448,333,323
2038,text,49,331,138,20,12.png,1024,1448,187,351
2039,text,233,327,75,26,12.png,1024,1448,308,353
2040,text,513,323,116,20,12.png,1024,1448,629,343
2041,text,47,357,52,18,12.png,1024,1448,99,375
2042,text,233,357,78,20,12.png,1024,1448,311,377
2043,text,634,362,162,24,12.png,1024,1448,796,386
2044,text,47,385,88,18,12.png,1024,1448,135,403
2045,text,233,385,40,18,12.png,1024,1448,273,403
2046,text,510,384,72,24,12.png,1024,1448,582,408
2047,text,47,409,143,24,12.png,1024,1448,190,433
2048,text,231,409,76,20,12.png,1024,1448,307,429
2049,text,44,434,82,25,12.png,1024,1448,126,459
2050,text,73,475,32,20,12.png,1024,1448,105,495
2051,text,143,475,48,20,12.png,1024,1448,191,495
2052,text,368,476,104,24,12.png,1024,1448,472,500
2053,text,659,477,36,20,12.png,1024,1448,695,497
2054,text,755,479,36,18,12.png,1024,1448,791,497
2055,text,877,479,44,18,12.png,1024,1448,921,497
2056,text,203,497,168,20,12.png,1024,1448,371,517
2057,text,659,499,34,18,12.png,1024,1448,693,517
2058,text,789,501,46,16,12.png,1024,1448,835,517
2059,text,913,501,46,16,12.png,1024,1448,959,517
2060,text,439,1107,66,18,12.png,1024,1448,505,1125
2061,text,717,1109,40,16,12.png,1024,1448,757,1125
2062,text,77,1115,58,18,12.png,1024,1448,135,1133
2063,text,211,1115,66,18,12.png,1024,1448,277,1133
2064,text,331,1115,72,20,12.png,1024,1448,403,1135
2065,text,563,1115,84,20,12.png,1024,1448,647,1135
2066,text,831,1117,80,20,12.png,1024,1448,911,1137
2067,text,453,1127,44,18,12.png,1024,1448,497,1145
2068,text,703,1127,64,16,12.png,1024,1448,767,1143
2069,text,81,1145,52,20,12.png,1024,1448,133,1165
2070,text,221,1147,50,18,12.png,1024,1448,271,1165
2071,text,382,1147,35,20,12.png,1024,1448,417,1167
2072,text,455,1147,36,20,12.png,1024,1448,491,1167
2073,text,581,1151,52,16,12.png,1024,1448,633,1167
2074,text,721,1151,34,16,12.png,1024,1448,755,1167
2075,text,845,1149,52,18,12.png,1024,1448,897,1167
2076,text,50,1182,295,24,12.png,1024,1448,345,1206
2077,text,348,1184,140,24,12.png,1024,1448,488,1208
2078,text,50,1209,420,25,12.png,1024,1448,470,1234
2079,text,212,1257,508,28,12.png,1024,1448,720,1285
2080,text,203,1287,528,18,12.png,1024,1448,731,1305
2081,text,80,497,21,19,12.png,1024,1448,101,516
2082,text,137,498,16,19,12.png,1024,1448,153,517
2083,text,265,41,462,44,12_contrasted.png,1024,1448,727,85
2084,text,411,85,172,20,12_contrasted.png,1024,1448,583,105
2085,text,283,101,216,18,12_contrasted.png,1024,1448,499,119
2086,text,507,103,198,18,12_contrasted.png,1024,1448,705,121
2087,text,253,117,30,18,12_contrasted.png,1024,1448,283,135
2088,text,291,117,206,20,12_contrasted.png,1024,1448,497,137
2089,text,505,119,91,18,12_contrasted.png,1024,1448,596,137
2090,text,600,119,137,18,12_contrasted.png,1024,1448,737,137
2091,text,187,135,46,16,12_contrasted.png,1024,1448,233,151
2092,text,245,137,166,16,12_contrasted.png,1024,1448,411,153
2093,text,419,135,386,21,12_contrasted.png,1024,1448,805,156
2094,text,155,153,72,16,12_contrasted.png,1024,1448,227,169
2095,text,237,153,40,16,12_contrasted.png,1024,1448,277,169
2096,text,287,153,76,16,12_contrasted.png,1024,1448,363,169
2097,text,373,153,58,18,12_contrasted.png,1024,1448,431,171
2098,text,437,153,40,16,12_contrasted.png,1024,1448,477,169
2099,text,485,153,64,18,12_contrasted.png,1024,1448,549,171
2100,text,559,155,52,16,12_contrasted.png,1024,1448,611,171
2101,text,619,155,66,16,12_contrasted.png,1024,1448,685,171
2102,text,691,154,143,17,12_contrasted.png,1024,1448,834,171
2103,text,629,195,121,26,12_contrasted.png,1024,1448,750,221
2104,text,758,196,90,24,12_contrasted.png,1024,1448,848,220
2105,text,56,216,152,28,12_contrasted.png,1024,1448,208,244
2106,text,224,216,126,28,12_contrasted.png,1024,1448,350,244
2107,text,49,253,70,20,12_contrasted.png,1024,1448,119,273
2108,text,513,255,72,20,12_contrasted.png,1024,1448,585,275
2109,text,49,279,48,20,12_contrasted.png,1024,1448,97,299
2110,text,235,279,42,20,12_contrasted.png,1024,1448,277,299
2111,text,47,305,134,18,12_contrasted.png,1024,1448,181,323
2112,text,235,307,98,16,12_contrasted.png,1024,1448,333,323
2113,text,49,331,138,20,12_contrasted.png,1024,1448,187,351
2114,text,233,327,75,26,12_contrasted.png,1024,1448,308,353
2115,text,513,323,116,20,12_contrasted.png,1024,1448,629,343
2116,text,47,357,52,18,12_contrasted.png,1024,1448,99,375
2117,text,233,357,78,20,12_contrasted.png,1024,1448,311,377
2118,text,634,362,162,24,12_contrasted.png,1024,1448,796,386
2119,text,47,385,88,18,12_contrasted.png,1024,1448,135,403
2120,text,233,385,40,18,12_contrasted.png,1024,1448,273,403
2121,text,510,384,72,24,12_contrasted.png,1024,1448,582,408
2122,text,47,409,143,24,12_contrasted.png,1024,1448,190,433
2123,text,231,409,76,20,12_contrasted.png,1024,1448,307,429
2124,text,44,434,82,25,12_contrasted.png,1024,1448,126,459
2125,text,73,475,32,20,12_contrasted.png,1024,1448,105,495
2126,text,143,475,48,20,12_contrasted.png,1024,1448,191,495
2127,text,368,476,104,24,12_contrasted.png,1024,1448,472,500
2128,text,659,477,36,20,12_contrasted.png,1024,1448,695,497
2129,text,755,479,36,18,12_contrasted.png,1024,1448,791,497
2130,text,877,479,44,18,12_contrasted.png,1024,1448,921,497
2131,text,203,497,168,20,12_contrasted.png,1024,1448,371,517
2132,text,659,499,34,18,12_contrasted.png,1024,1448,693,517
2133,text,789,501,46,16,12_contrasted.png,1024,1448,835,517
2134,text,913,501,46,16,12_contrasted.png,1024,1448,959,517
2135,text,439,1107,66,18,12_contrasted.png,1024,1448,505,1125
2136,text,717,1109,40,16,12_contrasted.png,1024,1448,757,1125
2137,text,77,1115,58,18,12_contrasted.png,1024,1448,135,1133
2138,text,211,1115,66,18,12_contrasted.png,1024,1448,277,1133
2139,text,331,1115,72,20,12_contrasted.png,1024,1448,403,1135
2140,text,563,1115,84,20,12_contrasted.png,1024,1448,647,1135
2141,text,831,1117,80,20,12_contrasted.png,1024,1448,911,1137
2142,text,453,1127,44,18,12_contrasted.png,1024,1448,497,1145
2143,text,703,1127,64,16,12_contrasted.png,1024,1448,767,1143
2144,text,81,1145,52,20,12_contrasted.png,1024,1448,133,1165
2145,text,221,1147,50,18,12_contrasted.png,1024,1448,271,1165
2146,text,382,1147,35,20,12_contrasted.png,1024,1448,417,1167
2147,text,455,1147,36,20,12_contrasted.png,1024,1448,491,1167
2148,text,581,1151,52,16,12_contrasted.png,1024,1448,633,1167
2149,text,721,1151,34,16,12_contrasted.png,1024,1448,755,1167
2150,text,845,1149,52,18,12_contrasted.png,1024,1448,897,1167
2151,text,50,1182,295,24,12_contrasted.png,1024,1448,345,1206
2152,text,348,1184,140,24,12_contrasted.png,1024,1448,488,1208
2153,text,50,1209,420,25,12_contrasted.png,1024,1448,470,1234
2154,text,212,1257,508,28,12_contrasted.png,1024,1448,720,1285
2155,text,203,1287,528,18,12_contrasted.png,1024,1448,731,1305
2156,text,80,497,21,19,12_contrasted.png,1024,1448,101,516
2157,text,137,498,16,19,12_contrasted.png,1024,1448,153,517
2158,text,265,41,462,44,12_denoise.png,1024,1448,727,85
2159,text,411,85,172,20,12_denoise.png,1024,1448,583,105
2160,text,283,101,216,18,12_denoise.png,1024,1448,499,119
2161,text,507,103,198,18,12_denoise.png,1024,1448,705,121
2162,text,253,117,30,18,12_denoise.png,1024,1448,283,135
2163,text,291,117,206,20,12_denoise.png,1024,1448,497,137
2164,text,505,119,91,18,12_denoise.png,1024,1448,596,137
2165,text,600,119,137,18,12_denoise.png,1024,1448,737,137
2166,text,187,135,46,16,12_denoise.png,1024,1448,233,151
2167,text,245,137,166,16,12_denoise.png,1024,1448,411,153
2168,text,419,135,386,21,12_denoise.png,1024,1448,805,156
2169,text,155,153,72,16,12_denoise.png,1024,1448,227,169
2170,text,237,153,40,16,12_denoise.png,1024,1448,277,169
2171,text,287,153,76,16,12_denoise.png,1024,1448,363,169
2172,text,373,153,58,18,12_denoise.png,1024,1448,431,171
2173,text,437,153,40,16,12_denoise.png,1024,1448,477,169
2174,text,485,153,64,18,12_denoise.png,1024,1448,549,171
2175,text,559,155,52,16,12_denoise.png,1024,1448,611,171
2176,text,619,155,66,16,12_denoise.png,1024,1448,685,171
2177,text,691,154,143,17,12_denoise.png,1024,1448,834,171
2178,text,629,195,121,26,12_denoise.png,1024,1448,750,221
2179,text,758,196,90,24,12_denoise.png,1024,1448,848,220
2180,text,56,216,152,28,12_denoise.png,1024,1448,208,244
2181,text,224,216,126,28,12_denoise.png,1024,1448,350,244
2182,text,49,253,70,20,12_denoise.png,1024,1448,119,273
2183,text,513,255,72,20,12_denoise.png,1024,1448,585,275
2184,text,49,279,48,20,12_denoise.png,1024,1448,97,299
2185,text,235,279,42,20,12_denoise.png,1024,1448,277,299
2186,text,47,305,134,18,12_denoise.png,1024,1448,181,323
2187,text,235,307,98,16,12_denoise.png,1024,1448,333,323
2188,text,49,331,138,20,12_denoise.png,1024,1448,187,351
2189,text,233,327,75,26,12_denoise.png,1024,1448,308,353
2190,text,513,323,116,20,12_denoise.png,1024,1448,629,343
2191,text,47,357,52,18,12_denoise.png,1024,1448,99,375
2192,text,233,357,78,20,12_denoise.png,1024,1448,311,377
2193,text,634,362,162,24,12_denoise.png,1024,1448,796,386
2194,text,47,385,88,18,12_denoise.png,1024,1448,135,403
2195,text,233,385,40,18,12_denoise.png,1024,1448,273,403
2196,text,510,384,72,24,12_denoise.png,1024,1448,582,408
2197,text,47,409,143,24,12_denoise.png,1024,1448,190,433
2198,text,231,409,76,20,12_denoise.png,1024,1448,307,429
2199,text,44,434,82,25,12_denoise.png,1024,1448,126,459
2200,text,73,475,32,20,12_denoise.png,1024,1448,105,495
2201,text,143,475,48,20,12_denoise.png,1024,1448,191,495
2202,text,368,476,104,24,12_denoise.png,1024,1448,472,500
2203,text,659,477,36,20,12_denoise.png,1024,1448,695,497
2204,text,755,479,36,18,12_denoise.png,1024,1448,791,497
2205,text,877,479,44,18,12_denoise.png,1024,1448,921,497
2206,text,203,497,168,20,12_denoise.png,1024,1448,371,517
2207,text,659,499,34,18,12_denoise.png,1024,1448,693,517
2208,text,789,501,46,16,12_denoise.png,1024,1448,835,517
2209,text,913,501,46,16,12_denoise.png,1024,1448,959,517
2210,text,439,1107,66,18,12_denoise.png,1024,1448,505,1125
2211,text,717,1109,40,16,12_denoise.png,1024,1448,757,1125
2212,text,77,1115,58,18,12_denoise.png,1024,1448,135,1133
2213,text,211,1115,66,18,12_denoise.png,1024,1448,277,1133
2214,text,331,1115,72,20,12_denoise.png,1024,1448,403,1135
2215,text,563,1115,84,20,12_denoise.png,1024,1448,647,1135
2216,text,831,1117,80,20,12_denoise.png,1024,1448,911,1137
2217,text,453,1127,44,18,12_denoise.png,1024,1448,497,1145
2218,text,703,1127,64,16,12_denoise.png,1024,1448,767,1143
2219,text,81,1145,52,20,12_denoise.png,1024,1448,133,1165
2220,text,221,1147,50,18,12_denoise.png,1024,1448,271,1165
2221,text,382,1147,35,20,12_denoise.png,1024,1448,417,1167
2222,text,455,1147,36,20,12_denoise.png,1024,1448,491,1167
2223,text,581,1151,52,16,12_denoise.png,1024,1448,633,1167
2224,text,721,1151,34,16,12_denoise.png,1024,1448,755,1167
2225,text,845,1149,52,18,12_denoise.png,1024,1448,897,1167
2226,text,50,1182,295,24,12_denoise.png,1024,1448,345,1206
2227,text,348,1184,140,24,12_denoise.png,1024,1448,488,1208
2228,text,50,1209,420,25,12_denoise.png,1024,1448,470,1234
2229,text,212,1257,508,28,12_denoise.png,1024,1448,720,1285
2230,text,203,1287,528,18,12_denoise.png,1024,1448,731,1305
2231,text,80,497,21,19,12_denoise.png,1024,1448,101,516
2232,text,137,498,16,19,12_denoise.png,1024,1448,153,517
2233,text,265,41,462,44,12_median.png,1024,1448,727,85
2234,text,411,85,172,20,12_median.png,1024,1448,583,105
2235,text,283,101,216,18,12_median.png,1024,1448,499,119
2236,text,507,103,198,18,12_median.png,1024,1448,705,121
2237,text,253,117,30,18,12_median.png,1024,1448,283,135
2238,text,291,117,206,20,12_median.png,1024,1448,497,137
2239,text,505,119,91,18,12_median.png,1024,1448,596,137
2240,text,600,119,137,18,12_median.png,1024,1448,737,137
2241,text,187,135,46,16,12_median.png,1024,1448,233,151
2242,text,245,137,166,16,12_median.png,1024,1448,411,153
2243,text,419,135,386,21,12_median.png,1024,1448,805,156
2244,text,155,153,72,16,12_median.png,1024,1448,227,169
2245,text,237,153,40,16,12_median.png,1024,1448,277,169
2246,text,287,153,76,16,12_median.png,1024,1448,363,169
2247,text,373,153,58,18,12_median.png,1024,1448,431,171
2248,text,437,153,40,16,12_median.png,1024,1448,477,169
2249,text,485,153,64,18,12_median.png,1024,1448,549,171
2250,text,559,155,52,16,12_median.png,1024,1448,611,171
2251,text,619,155,66,16,12_median.png,1024,1448,685,171
2252,text,691,154,143,17,12_median.png,1024,1448,834,171
2253,text,629,195,121,26,12_median.png,1024,1448,750,221
2254,text,758,196,90,24,12_median.png,1024,1448,848,220
2255,text,56,216,152,28,12_median.png,1024,1448,208,244
2256,text,224,216,126,28,12_median.png,1024,1448,350,244
2257,text,49,253,70,20,12_median.png,1024,1448,119,273
2258,text,513,255,72,20,12_median.png,1024,1448,585,275
2259,text,49,279,48,20,12_median.png,1024,1448,97,299
2260,text,235,279,42,20,12_median.png,1024,1448,277,299
2261,text,47,305,134,18,12_median.png,1024,1448,181,323
2262,text,235,307,98,16,12_median.png,1024,1448,333,323
2263,text,49,331,138,20,12_median.png,1024,1448,187,351
2264,text,233,327,75,26,12_median.png,1024,1448,308,353
2265,text,513,323,116,20,12_median.png,1024,1448,629,343
2266,text,47,357,52,18,12_median.png,1024,1448,99,375
2267,text,233,357,78,20,12_median.png,1024,1448,311,377
2268,text,634,362,162,24,12_median.png,1024,1448,796,386
2269,text,47,385,88,18,12_median.png,1024,1448,135,403
2270,text,233,385,40,18,12_median.png,1024,1448,273,403
2271,text,510,384,72,24,12_median.png,1024,1448,582,408
2272,text,47,409,143,24,12_median.png,1024,1448,190,433
2273,text,231,409,76,20,12_median.png,1024,1448,307,429
2274,text,44,434,82,25,12_median.png,1024,1448,126,459
2275,text,73,475,32,20,12_median.png,1024,1448,105,495
2276,text,143,475,48,20,12_median.png,1024,1448,191,495
2277,text,368,476,104,24,12_median.png,1024,1448,472,500
2278,text,659,477,36,20,12_median.png,1024,1448,695,497
2279,text,755,479,36,18,12_median.png,1024,1448,791,497
2280,text,877,479,44,18,12_median.png,1024,1448,921,497
2281,text,203,497,168,20,12_median.png,1024,1448,371,517
2282,text,659,499,34,18,12_median.png,1024,1448,693,517
2283,text,789,501,46,16,12_median.png,1024,1448,835,517
2284,text,913,501,46,16,12_median.png,1024,1448,959,517
2285,text,439,1107,66,18,12_median.png,1024,1448,505,1125
2286,text,717,1109,40,16,12_median.png,1024,1448,757,1125
2287,text,77,1115,58,18,12_median.png,1024,1448,135,1133
2288,text,211,1115,66,18,12_median.png,1024,1448,277,1133
2289,text,331,1115,72,20,12_median.png,1024,1448,403,1135
2290,text,563,1115,84,20,12_median.png,1024,1448,647,1135
2291,text,831,1117,80,20,12_median.png,1024,1448,911,1137
2292,text,453,1127,44,18,12_median.png,1024,1448,497,1145
2293,text,703,1127,64,16,12_median.png,1024,1448,767,1143
2294,text,81,1145,52,20,12_median.png,1024,1448,133,1165
2295,text,221,1147,50,18,12_median.png,1024,1448,271,1165
2296,text,382,1147,35,20,12_median.png,1024,1448,417,1167
2297,text,455,1147,36,20,12_median.png,1024,1448,491,1167
2298,text,581,1151,52,16,12_median.png,1024,1448,633,1167
2299,text,721,1151,34,16,12_median.png,1024,1448,755,1167
2300,text,845,1149,52,18,12_median.png,1024,1448,897,1167
2301,text,50,1182,295,24,12_median.png,1024,1448,345,1206
2302,text,348,1184,140,24,12_median.png,1024,1448,488,1208
2303,text,50,1209,420,25,12_median.png,1024,1448,470,1234
2304,text,212,1257,508,28,12_median.png,1024,1448,720,1285
2305,text,203,1287,528,18,12_median.png,1024,1448,731,1305
2306,text,80,497,21,19,12_median.png,1024,1448,101,516
2307,text,137,498,16,19,12_median.png,1024,1448,153,517
2308,text,59,123,60,20,13.png,1024,1448,119,143
2309,text,52,138,272,26,13.png,1024,1448,324,164
2310,text,581,137,152,20,13.png,1024,1448,733,157
2311,text,53,160,170,21,13.png,1024,1448,223,181
2312,text,578,173,262,25,13.png,1024,1448,840,198
2313,text,52,198,254,26,13.png,1024,1448,306,224
2314,text,52,218,286,24,13.png,1024,1448,338,242
2315,text,585,215,50,20,13.png,1024,1448,635,235
2316,text,53,241,54,20,13.png,1024,1448,107,261
2317,text,52,258,172,24,13.png,1024,1448,224,282
2318,text,53,279,144,20,13.png,1024,1448,197,299
2319,text,207,279,36,20,13.png,1024,1448,243,299
2320,text,250,276,108,24,13.png,1024,1448,358,300
2321,text,53,313,84,20,13.png,1024,1448,137,333
2322,text,145,313,94,20,13.png,1024,1448,239,333
2323,text,55,341,60,16,13.png,1024,1448,115,357
2324,text,125,337,232,20,13.png,1024,1448,357,357
2325,text,297,371,74,20,13.png,1024,1448,371,391
2326,text,754,366,116,24,13.png,1024,1448,870,390
2327,text,61,417,90,18,13.png,1024,1448,151,435
2328,text,181,413,136,20,13.png,1024,1448,317,433
2329,text,645,415,66,16,13.png,1024,1448,711,431
2330,text,801,411,100,20,13.png,1024,1448,901,431
2331,text,61,439,76,20,13.png,1024,1448,137,459
2332,text,179,435,155,25,13.png,1024,1448,334,460
2333,text,643,437,94,18,13.png,1024,1448,737,455
2334,text,799,435,82,20,13.png,1024,1448,881,455
2335,text,61,467,46,16,13.png,1024,1448,107,483
2336,text,180,462,120,24,13.png,1024,1448,300,486
2337,text,643,461,148,20,13.png,1024,1448,791,481
2338,text,799,459,80,20,13.png,1024,1448,879,479
2339,text,67,491,50,18,13.png,1024,1448,117,509
2340,text,181,487,36,20,13.png,1024,1448,217,507
2341,text,387,489,74,16,13.png,1024,1448,461,505
2342,text,561,485,48,20,13.png,1024,1448,609,505
2343,text,645,487,72,18,13.png,1024,1448,717,505
2344,text,801,483,116,20,13.png,1024,1448,917,503
2345,text,59,510,167,24,13.png,1024,1448,226,534
2346,text,253,511,22,20,13.png,1024,1448,275,531
2347,text,383,506,91,29,13.png,1024,1448,474,535
2348,text,527,509,82,20,13.png,1024,1448,609,529
2349,text,642,508,102,24,13.png,1024,1448,744,532
2350,text,799,507,158,20,13.png,1024,1448,957,527
2351,text,91,565,111,25,13.png,1024,1448,202,590
2352,text,289,567,56,20,13.png,1024,1448,345,587
2353,text,424,564,120,24,13.png,1024,1448,544,588
2354,text,645,565,58,20,13.png,1024,1448,703,585
2355,text,825,561,109,26,13.png,1024,1448,934,587
2356,text,99,615,84,20,13.png,1024,1448,183,635
2357,text,285,615,62,18,13.png,1024,1448,347,633
2358,text,449,613,74,20,13.png,1024,1448,523,633
2359,text,579,613,90,18,13.png,1024,1448,669,631
2360,text,895,611,82,20,13.png,1024,1448,977,631
2361,text,579,637,68,20,13.png,1024,1448,647,657
2362,text,903,635,74,20,13.png,1024,1448,977,655
2363,text,581,713,58,16,13.png,1024,1448,639,729
2364,text,905,711,72,16,13.png,1024,1448,977,727
2365,text,579,729,58,20,13.png,1024,1448,637,749
2366,text,903,727,74,20,13.png,1024,1448,977,747
2367,text,581,751,120,18,13.png,1024,1448,701,769
2368,text,903,747,74,20,13.png,1024,1448,977,767
2369,text,581,769,84,20,13.png,1024,1448,665,789
2370,text,903,767,74,20,13.png,1024,1448,977,787
2371,text,579,823,92,20,13.png,1024,1448,671,843
2372,text,55,861,83,20,13.png,1024,1448,138,881
2373,text,148,860,88,24,13.png,1024,1448,236,884
2374,text,242,858,126,24,13.png,1024,1448,368,882
2375,text,375,858,92,24,13.png,1024,1448,467,882
2376,text,60,913,340,25,13.png,1024,1448,400,938
2377,text,465,957,102,20,13.png,1024,1448,567,977
2378,text,71,991,122,18,13.png,1024,1448,193,1009
2379,text,199,989,48,18,13.png,1024,1448,247,1007
2380,text,638,982,178,24,13.png,1024,1448,816,1006
2381,text,71,1015,88,18,13.png,1024,1448,159,1033
2382,text,165,1015,72,16,13.png,1024,1448,237,1031
2383,text,639,1011,66,18,13.png,1024,1448,705,1029
2384,text,55,1325,54,18,13.png,1024,1448,109,1343
2385,text,241,1323,214,20,13.png,1024,1448,455,1343
2386,text,461,1321,136,20,13.png,1024,1448,597,1341
2387,text,301,1341,98,18,13.png,1024,1448,399,1359
2388,text,403,1339,228,18,13.png,1024,1448,631,1357
2389,text,57,1357,204,20,13.png,1024,1448,261,1377
2390,text,301,1355,286,20,13.png,1024,1448,587,1375
2391,text,595,1355,143,18,13.png,1024,1448,738,1373
2392,text,877,822,102,19,13.png,1024,1448,979,841
2393,text,746,1355,121,18,13.png,1024,1448,867,1373
2394,text,59,123,60,20,13_contrasted.png,1024,1448,119,143
2395,text,52,138,272,26,13_contrasted.png,1024,1448,324,164
2396,text,581,137,152,20,13_contrasted.png,1024,1448,733,157
2397,text,53,160,170,21,13_contrasted.png,1024,1448,223,181
2398,text,578,173,262,25,13_contrasted.png,1024,1448,840,198
2399,text,52,198,254,26,13_contrasted.png,1024,1448,306,224
2400,text,52,218,286,24,13_contrasted.png,1024,1448,338,242
2401,text,585,215,50,20,13_contrasted.png,1024,1448,635,235
2402,text,53,241,54,20,13_contrasted.png,1024,1448,107,261
2403,text,52,258,172,24,13_contrasted.png,1024,1448,224,282
2404,text,53,279,144,20,13_contrasted.png,1024,1448,197,299
2405,text,207,279,36,20,13_contrasted.png,1024,1448,243,299
2406,text,250,276,108,24,13_contrasted.png,1024,1448,358,300
2407,text,53,313,84,20,13_contrasted.png,1024,1448,137,333
2408,text,145,313,94,20,13_contrasted.png,1024,1448,239,333
2409,text,55,341,60,16,13_contrasted.png,1024,1448,115,357
2410,text,125,337,232,20,13_contrasted.png,1024,1448,357,357
2411,text,297,371,74,20,13_contrasted.png,1024,1448,371,391
2412,text,754,366,116,24,13_contrasted.png,1024,1448,870,390
2413,text,61,417,90,18,13_contrasted.png,1024,1448,151,435
2414,text,181,413,136,20,13_contrasted.png,1024,1448,317,433
2415,text,645,415,66,16,13_contrasted.png,1024,1448,711,431
2416,text,801,411,100,20,13_contrasted.png,1024,1448,901,431
2417,text,61,439,76,20,13_contrasted.png,1024,1448,137,459
2418,text,179,435,155,25,13_contrasted.png,1024,1448,334,460
2419,text,643,437,94,18,13_contrasted.png,1024,1448,737,455
2420,text,799,435,82,20,13_contrasted.png,1024,1448,881,455
2421,text,61,467,46,16,13_contrasted.png,1024,1448,107,483
2422,text,180,462,120,24,13_contrasted.png,1024,1448,300,486
2423,text,643,461,148,20,13_contrasted.png,1024,1448,791,481
2424,text,799,459,80,20,13_contrasted.png,1024,1448,879,479
2425,text,67,491,50,18,13_contrasted.png,1024,1448,117,509
2426,text,181,487,36,20,13_contrasted.png,1024,1448,217,507
2427,text,387,489,74,16,13_contrasted.png,1024,1448,461,505
2428,text,561,485,48,20,13_contrasted.png,1024,1448,609,505
2429,text,645,487,72,18,13_contrasted.png,1024,1448,717,505
2430,text,801,483,116,20,13_contrasted.png,1024,1448,917,503
2431,text,59,510,167,24,13_contrasted.png,1024,1448,226,534
2432,text,253,511,22,20,13_contrasted.png,1024,1448,275,531
2433,text,383,506,91,29,13_contrasted.png,1024,1448,474,535
2434,text,527,509,82,20,13_contrasted.png,1024,1448,609,529
2435,text,642,508,102,24,13_contrasted.png,1024,1448,744,532
2436,text,799,507,158,20,13_contrasted.png,1024,1448,957,527
2437,text,91,565,111,25,13_contrasted.png,1024,1448,202,590
2438,text,289,567,56,20,13_contrasted.png,1024,1448,345,587
2439,text,424,564,120,24,13_contrasted.png,1024,1448,544,588
2440,text,645,565,58,20,13_contrasted.png,1024,1448,703,585
2441,text,825,561,109,26,13_contrasted.png,1024,1448,934,587
2442,text,99,615,84,20,13_contrasted.png,1024,1448,183,635
2443,text,285,615,62,18,13_contrasted.png,1024,1448,347,633
2444,text,449,613,74,20,13_contrasted.png,1024,1448,523,633
2445,text,579,613,90,18,13_contrasted.png,1024,1448,669,631
2446,text,895,611,82,20,13_contrasted.png,1024,1448,977,631
2447,text,579,637,68,20,13_contrasted.png,1024,1448,647,657
2448,text,903,635,74,20,13_contrasted.png,1024,1448,977,655
2449,text,581,713,58,16,13_contrasted.png,1024,1448,639,729
2450,text,905,711,72,16,13_contrasted.png,1024,1448,977,727
2451,text,579,729,58,20,13_contrasted.png,1024,1448,637,749
2452,text,903,727,74,20,13_contrasted.png,1024,1448,977,747
2453,text,581,751,120,18,13_contrasted.png,1024,1448,701,769
2454,text,903,747,74,20,13_contrasted.png,1024,1448,977,767
2455,text,581,769,84,20,13_contrasted.png,1024,1448,665,789
2456,text,903,767,74,20,13_contrasted.png,1024,1448,977,787
2457,text,579,823,92,20,13_contrasted.png,1024,1448,671,843
2458,text,55,861,83,20,13_contrasted.png,1024,1448,138,881
2459,text,148,860,88,24,13_contrasted.png,1024,1448,236,884
2460,text,242,858,126,24,13_contrasted.png,1024,1448,368,882
2461,text,375,858,92,24,13_contrasted.png,1024,1448,467,882
2462,text,60,913,340,25,13_contrasted.png,1024,1448,400,938
2463,text,465,957,102,20,13_contrasted.png,1024,1448,567,977
2464,text,71,991,122,18,13_contrasted.png,1024,1448,193,1009
2465,text,199,989,48,18,13_contrasted.png,1024,1448,247,1007
2466,text,638,982,178,24,13_contrasted.png,1024,1448,816,1006
2467,text,71,1015,88,18,13_contrasted.png,1024,1448,159,1033
2468,text,165,1015,72,16,13_contrasted.png,1024,1448,237,1031
2469,text,639,1011,66,18,13_contrasted.png,1024,1448,705,1029
2470,text,55,1325,54,18,13_contrasted.png,1024,1448,109,1343
2471,text,241,1323,214,20,13_contrasted.png,1024,1448,455,1343
2472,text,461,1321,136,20,13_contrasted.png,1024,1448,597,1341
2473,text,301,1341,98,18,13_contrasted.png,1024,1448,399,1359
2474,text,403,1339,228,18,13_contrasted.png,1024,1448,631,1357
2475,text,57,1357,204,20,13_contrasted.png,1024,1448,261,1377
2476,text,301,1355,286,20,13_contrasted.png,1024,1448,587,1375
2477,text,595,1355,143,18,13_contrasted.png,1024,1448,738,1373
2478,text,877,822,102,19,13_contrasted.png,1024,1448,979,841
2479,text,746,1355,121,18,13_contrasted.png,1024,1448,867,1373
2480,text,59,123,60,20,13_denoise.png,1024,1448,119,143
2481,text,52,138,272,26,13_denoise.png,1024,1448,324,164
2482,text,581,137,152,20,13_denoise.png,1024,1448,733,157
2483,text,53,160,170,21,13_denoise.png,1024,1448,223,181
2484,text,578,173,262,25,13_denoise.png,1024,1448,840,198
2485,text,52,198,254,26,13_denoise.png,1024,1448,306,224
2486,text,52,218,286,24,13_denoise.png,1024,1448,338,242
2487,text,585,215,50,20,13_denoise.png,1024,1448,635,235
2488,text,53,241,54,20,13_denoise.png,1024,1448,107,261
2489,text,52,258,172,24,13_denoise.png,1024,1448,224,282
2490,text,53,279,144,20,13_denoise.png,1024,1448,197,299
2491,text,207,279,36,20,13_denoise.png,1024,1448,243,299
2492,text,250,276,108,24,13_denoise.png,1024,1448,358,300
2493,text,53,313,84,20,13_denoise.png,1024,1448,137,333
2494,text,145,313,94,20,13_denoise.png,1024,1448,239,333
2495,text,55,341,60,16,13_denoise.png,1024,1448,115,357
2496,text,125,337,232,20,13_denoise.png,1024,1448,357,357
2497,text,297,371,74,20,13_denoise.png,1024,1448,371,391
2498,text,754,366,116,24,13_denoise.png,1024,1448,870,390
2499,text,61,417,90,18,13_denoise.png,1024,1448,151,435
2500,text,181,413,136,20,13_denoise.png,1024,1448,317,433
2501,text,645,415,66,16,13_denoise.png,1024,1448,711,431
2502,text,801,411,100,20,13_denoise.png,1024,1448,901,431
2503,text,61,439,76,20,13_denoise.png,1024,1448,137,459
2504,text,179,435,155,25,13_denoise.png,1024,1448,334,460
2505,text,643,437,94,18,13_denoise.png,1024,1448,737,455
2506,text,799,435,82,20,13_denoise.png,1024,1448,881,455
2507,text,61,467,46,16,13_denoise.png,1024,1448,107,483
2508,text,180,462,120,24,13_denoise.png,1024,1448,300,486
2509,text,643,461,148,20,13_denoise.png,1024,1448,791,481
2510,text,799,459,80,20,13_denoise.png,1024,1448,879,479
2511,text,67,491,50,18,13_denoise.png,1024,1448,117,509
2512,text,181,487,36,20,13_denoise.png,1024,1448,217,507
2513,text,387,489,74,16,13_denoise.png,1024,1448,461,505
2514,text,561,485,48,20,13_denoise.png,1024,1448,609,505
2515,text,645,487,72,18,13_denoise.png,1024,1448,717,505
2516,text,801,483,116,20,13_denoise.png,1024,1448,917,503
2517,text,59,510,167,24,13_denoise.png,1024,1448,226,534
2518,text,253,511,22,20,13_denoise.png,1024,1448,275,531
2519,text,383,506,91,29,13_denoise.png,1024,1448,474,535
2520,text,527,509,82,20,13_denoise.png,1024,1448,609,529
2521,text,642,508,102,24,13_denoise.png,1024,1448,744,532
2522,text,799,507,158,20,13_denoise.png,1024,1448,957,527
2523,text,91,565,111,25,13_denoise.png,1024,1448,202,590
2524,text,289,567,56,20,13_denoise.png,1024,1448,345,587
2525,text,424,564,120,24,13_denoise.png,1024,1448,544,588
2526,text,645,565,58,20,13_denoise.png,1024,1448,703,585
2527,text,825,561,109,26,13_denoise.png,1024,1448,934,587
2528,text,99,615,84,20,13_denoise.png,1024,1448,183,635
2529,text,285,615,62,18,13_denoise.png,1024,1448,347,633
2530,text,449,613,74,20,13_denoise.png,1024,1448,523,633
2531,text,579,613,90,18,13_denoise.png,1024,1448,669,631
2532,text,895,611,82,20,13_denoise.png,1024,1448,977,631
2533,text,579,637,68,20,13_denoise.png,1024,1448,647,657
2534,text,903,635,74,20,13_denoise.png,1024,1448,977,655
2535,text,581,713,58,16,13_denoise.png,1024,1448,639,729
2536,text,905,711,72,16,13_denoise.png,1024,1448,977,727
2537,text,579,729,58,20,13_denoise.png,1024,1448,637,749
2538,text,903,727,74,20,13_denoise.png,1024,1448,977,747
2539,text,581,751,120,18,13_denoise.png,1024,1448,701,769
2540,text,903,747,74,20,13_denoise.png,1024,1448,977,767
2541,text,581,769,84,20,13_denoise.png,1024,1448,665,789
2542,text,903,767,74,20,13_denoise.png,1024,1448,977,787
2543,text,579,823,92,20,13_denoise.png,1024,1448,671,843
2544,text,55,861,83,20,13_denoise.png,1024,1448,138,881
2545,text,148,860,88,24,13_denoise.png,1024,1448,236,884
2546,text,242,858,126,24,13_denoise.png,1024,1448,368,882
2547,text,375,858,92,24,13_denoise.png,1024,1448,467,882
2548,text,60,913,340,25,13_denoise.png,1024,1448,400,938
2549,text,465,957,102,20,13_denoise.png,1024,1448,567,977
2550,text,71,991,122,18,13_denoise.png,1024,1448,193,1009
2551,text,199,989,48,18,13_denoise.png,1024,1448,247,1007
2552,text,638,982,178,24,13_denoise.png,1024,1448,816,1006
2553,text,71,1015,88,18,13_denoise.png,1024,1448,159,1033
2554,text,165,1015,72,16,13_denoise.png,1024,1448,237,1031
2555,text,639,1011,66,18,13_denoise.png,1024,1448,705,1029
2556,text,55,1325,54,18,13_denoise.png,1024,1448,109,1343
2557,text,241,1323,214,20,13_denoise.png,1024,1448,455,1343
2558,text,461,1321,136,20,13_denoise.png,1024,1448,597,1341
2559,text,301,1341,98,18,13_denoise.png,1024,1448,399,1359
2560,text,403,1339,228,18,13_denoise.png,1024,1448,631,1357
2561,text,57,1357,204,20,13_denoise.png,1024,1448,261,1377
2562,text,301,1355,286,20,13_denoise.png,1024,1448,587,1375
2563,text,595,1355,143,18,13_denoise.png,1024,1448,738,1373
2564,text,877,822,102,19,13_denoise.png,1024,1448,979,841
2565,text,746,1355,121,18,13_denoise.png,1024,1448,867,1373
2566,text,59,123,60,20,13_median.png,1024,1448,119,143
2567,text,52,138,272,26,13_median.png,1024,1448,324,164
2568,text,581,137,152,20,13_median.png,1024,1448,733,157
2569,text,53,160,170,21,13_median.png,1024,1448,223,181
2570,text,578,173,262,25,13_median.png,1024,1448,840,198
2571,text,52,198,254,26,13_median.png,1024,1448,306,224
2572,text,52,218,286,24,13_median.png,1024,1448,338,242
2573,text,585,215,50,20,13_median.png,1024,1448,635,235
2574,text,53,241,54,20,13_median.png,1024,1448,107,261
2575,text,52,258,172,24,13_median.png,1024,1448,224,282
2576,text,53,279,144,20,13_median.png,1024,1448,197,299
2577,text,207,279,36,20,13_median.png,1024,1448,243,299
2578,text,250,276,108,24,13_median.png,1024,1448,358,300
2579,text,53,313,84,20,13_median.png,1024,1448,137,333
2580,text,145,313,94,20,13_median.png,1024,1448,239,333
2581,text,55,341,60,16,13_median.png,1024,1448,115,357
2582,text,125,337,232,20,13_median.png,1024,1448,357,357
2583,text,297,371,74,20,13_median.png,1024,1448,371,391
2584,text,754,366,116,24,13_median.png,1024,1448,870,390
2585,text,61,417,90,18,13_median.png,1024,1448,151,435
2586,text,181,413,136,20,13_median.png,1024,1448,317,433
2587,text,645,415,66,16,13_median.png,1024,1448,711,431
2588,text,801,411,100,20,13_median.png,1024,1448,901,431
2589,text,61,439,76,20,13_median.png,1024,1448,137,459
2590,text,179,435,155,25,13_median.png,1024,1448,334,460
2591,text,643,437,94,18,13_median.png,1024,1448,737,455
2592,text,799,435,82,20,13_median.png,1024,1448,881,455
2593,text,61,467,46,16,13_median.png,1024,1448,107,483
2594,text,180,462,120,24,13_median.png,1024,1448,300,486
2595,text,643,461,148,20,13_median.png,1024,1448,791,481
2596,text,799,459,80,20,13_median.png,1024,1448,879,479
2597,text,67,491,50,18,13_median.png,1024,1448,117,509
2598,text,181,487,36,20,13_median.png,1024,1448,217,507
2599,text,387,489,74,16,13_median.png,1024,1448,461,505
2600,text,561,485,48,20,13_median.png,1024,1448,609,505
2601,text,645,487,72,18,13_median.png,1024,1448,717,505
2602,text,801,483,116,20,13_median.png,1024,1448,917,503
2603,text,59,510,167,24,13_median.png,1024,1448,226,534
2604,text,253,511,22,20,13_median.png,1024,1448,275,531
2605,text,383,506,91,29,13_median.png,1024,1448,474,535
2606,text,527,509,82,20,13_median.png,1024,1448,609,529
2607,text,642,508,102,24,13_median.png,1024,1448,744,532
2608,text,799,507,158,20,13_median.png,1024,1448,957,527
2609,text,91,565,111,25,13_median.png,1024,1448,202,590
2610,text,289,567,56,20,13_median.png,1024,1448,345,587
2611,text,424,564,120,24,13_median.png,1024,1448,544,588
2612,text,645,565,58,20,13_median.png,1024,1448,703,585
2613,text,825,561,109,26,13_median.png,1024,1448,934,587
2614,text,99,615,84,20,13_median.png,1024,1448,183,635
2615,text,285,615,62,18,13_median.png,1024,1448,347,633
2616,text,449,613,74,20,13_median.png,1024,1448,523,633
2617,text,579,613,90,18,13_median.png,1024,1448,669,631
2618,text,895,611,82,20,13_median.png,1024,1448,977,631
2619,text,579,637,68,20,13_median.png,1024,1448,647,657
2620,text,903,635,74,20,13_median.png,1024,1448,977,655
2621,text,581,713,58,16,13_median.png,1024,1448,639,729
2622,text,905,711,72,16,13_median.png,1024,1448,977,727
2623,text,579,729,58,20,13_median.png,1024,1448,637,749
2624,text,903,727,74,20,13_median.png,1024,1448,977,747
2625,text,581,751,120,18,13_median.png,1024,1448,701,769
2626,text,903,747,74,20,13_median.png,1024,1448,977,767
2627,text,581,769,84,20,13_median.png,1024,1448,665,789
2628,text,903,767,74,20,13_median.png,1024,1448,977,787
2629,text,579,823,92,20,13_median.png,1024,1448,671,843
2630,text,55,861,83,20,13_median.png,1024,1448,138,881
2631,text,148,860,88,24,13_median.png,1024,1448,236,884
2632,text,242,858,126,24,13_median.png,1024,1448,368,882
2633,text,375,858,92,24,13_median.png,1024,1448,467,882
2634,text,60,913,340,25,13_median.png,1024,1448,400,938
2635,text,465,957,102,20,13_median.png,1024,1448,567,977
2636,text,71,991,122,18,13_median.png,1024,1448,193,1009
2637,text,199,989,48,18,13_median.png,1024,1448,247,1007
2638,text,638,982,178,24,13_median.png,1024,1448,816,1006
2639,text,71,1015,88,18,13_median.png,1024,1448,159,1033
2640,text,165,1015,72,16,13_median.png,1024,1448,237,1031
2641,text,639,1011,66,18,13_median.png,1024,1448,705,1029
2642,text,55,1325,54,18,13_median.png,1024,1448,109,1343
2643,text,241,1323,214,20,13_median.png,1024,1448,455,1343
2644,text,461,1321,136,20,13_median.png,1024,1448,597,1341
2645,text,301,1341,98,18,13_median.png,1024,1448,399,1359
2646,text,403,1339,228,18,13_median.png,1024,1448,631,1357
2647,text,57,1357,204,20,13_median.png,1024,1448,261,1377
2648,text,301,1355,286,20,13_median.png,1024,1448,587,1375
2649,text,595,1355,143,18,13_median.png,1024,1448,738,1373
2650,text,877,822,102,19,13_median.png,1024,1448,979,841
2651,text,746,1355,121,18,13_median.png,1024,1448,867,1373
2652,text,203,85,366,42,14.png,1024,1430,569,127
2653,text,204,126,230,28,14.png,1024,1430,434,154
2654,text,454,128,112,26,14.png,1024,1430,566,154
2655,text,206,160,360,30,14.png,1024,1430,566,190
2656,text,116,301,118,24,14.png,1024,1430,234,325
2657,text,616,298,156,24,14.png,1024,1430,772,322
2658,text,615,325,32,20,14.png,1024,1430,647,345
2659,text,658,322,156,24,14.png,1024,1430,814,346
2660,text,445,411,144,20,14.png,1024,1430,589,431
2661,text,103,495,86,20,14.png,1024,1430,189,515
2662,text,284,494,100,26,14.png,1024,1430,384,520
2663,text,719,490,61,26,14.png,1024,1430,780,516
2664,text,851,493,98,20,14.png,1024,1430,949,513
2665,text,131,561,46,20,14.png,1024,1430,177,581
2666,text,242,558,420,26,14.png,1024,1430,662,584
2667,text,721,559,70,20,14.png,1024,1430,791,579
2668,text,871,559,70,20,14.png,1024,1430,941,579
2669,text,238,579,186,28,14.png,1024,1430,424,607
2670,text,238,602,424,26,14.png,1024,1430,662,628
2671,text,721,603,70,20,14.png,1024,1430,791,623
2672,text,871,603,70,20,14.png,1024,1430,941,623
2673,text,238,624,190,24,14.png,1024,1430,428,648
2674,text,623,827,72,20,14.png,1024,1430,695,847
2675,text,855,827,66,18,14.png,1024,1430,921,845
2676,text,621,853,84,20,14.png,1024,1430,705,873
2677,text,864,850,60,24,14.png,1024,1430,924,874
2678,text,621,879,78,20,14.png,1024,1430,699,899
2679,text,857,877,66,20,14.png,1024,1430,923,897
2680,text,74,1082,334,26,14.png,1024,1430,408,1108
2681,text,415,1085,164,20,14.png,1024,1430,579,1105
2682,text,34,1348,354,25,14.png,1024,1430,388,1373
2683,text,399,1353,52,16,14.png,1024,1430,451,1369
2684,text,457,1351,150,18,14.png,1024,1430,607,1369
2685,text,617,1351,264,20,14.png,1024,1430,881,1371
2686,text,32,1372,239,24,14.png,1024,1430,271,1396
2687,text,283,1370,185,26,14.png,1024,1430,468,1396
2688,text,479,1371,90,24,14.png,1024,1430,569,1395
2689,text,579,1371,141,27,14.png,1024,1430,720,1398
2690,text,730,1372,97,23,14.png,1024,1430,827,1395
2691,text,836,1371,115,27,14.png,1024,1430,951,1398
2692,text,203,85,366,42,14_contrasted.png,1024,1430,569,127
2693,text,204,126,230,28,14_contrasted.png,1024,1430,434,154
2694,text,454,128,112,26,14_contrasted.png,1024,1430,566,154
2695,text,206,160,360,30,14_contrasted.png,1024,1430,566,190
2696,text,116,301,118,24,14_contrasted.png,1024,1430,234,325
2697,text,616,298,156,24,14_contrasted.png,1024,1430,772,322
2698,text,615,325,32,20,14_contrasted.png,1024,1430,647,345
2699,text,658,322,156,24,14_contrasted.png,1024,1430,814,346
2700,text,445,411,144,20,14_contrasted.png,1024,1430,589,431
2701,text,103,495,86,20,14_contrasted.png,1024,1430,189,515
2702,text,284,494,100,26,14_contrasted.png,1024,1430,384,520
2703,text,719,490,61,26,14_contrasted.png,1024,1430,780,516
2704,text,851,493,98,20,14_contrasted.png,1024,1430,949,513
2705,text,131,561,46,20,14_contrasted.png,1024,1430,177,581
2706,text,242,558,420,26,14_contrasted.png,1024,1430,662,584
2707,text,721,559,70,20,14_contrasted.png,1024,1430,791,579
2708,text,871,559,70,20,14_contrasted.png,1024,1430,941,579
2709,text,238,579,186,28,14_contrasted.png,1024,1430,424,607
2710,text,238,602,424,26,14_contrasted.png,1024,1430,662,628
2711,text,721,603,70,20,14_contrasted.png,1024,1430,791,623
2712,text,871,603,70,20,14_contrasted.png,1024,1430,941,623
2713,text,238,624,190,24,14_contrasted.png,1024,1430,428,648
2714,text,623,827,72,20,14_contrasted.png,1024,1430,695,847
2715,text,855,827,66,18,14_contrasted.png,1024,1430,921,845
2716,text,621,853,84,20,14_contrasted.png,1024,1430,705,873
2717,text,864,850,60,24,14_contrasted.png,1024,1430,924,874
2718,text,621,879,78,20,14_contrasted.png,1024,1430,699,899
2719,text,857,877,66,20,14_contrasted.png,1024,1430,923,897
2720,text,74,1082,334,26,14_contrasted.png,1024,1430,408,1108
2721,text,415,1085,164,20,14_contrasted.png,1024,1430,579,1105
2722,text,34,1348,354,25,14_contrasted.png,1024,1430,388,1373
2723,text,399,1353,52,16,14_contrasted.png,1024,1430,451,1369
2724,text,457,1351,150,18,14_contrasted.png,1024,1430,607,1369
2725,text,617,1351,264,20,14_contrasted.png,1024,1430,881,1371
2726,text,32,1372,239,24,14_contrasted.png,1024,1430,271,1396
2727,text,283,1370,185,26,14_contrasted.png,1024,1430,468,1396
2728,text,479,1371,90,24,14_contrasted.png,1024,1430,569,1395
2729,text,579,1371,141,27,14_contrasted.png,1024,1430,720,1398
2730,text,730,1372,97,23,14_contrasted.png,1024,1430,827,1395
2731,text,836,1371,115,27,14_contrasted.png,1024,1430,951,1398
2732,text,203,85,366,42,14_denoise.png,1024,1430,569,127
2733,text,204,126,230,28,14_denoise.png,1024,1430,434,154
2734,text,454,128,112,26,14_denoise.png,1024,1430,566,154
2735,text,206,160,360,30,14_denoise.png,1024,1430,566,190
2736,text,116,301,118,24,14_denoise.png,1024,1430,234,325
2737,text,616,298,156,24,14_denoise.png,1024,1430,772,322
2738,text,615,325,32,20,14_denoise.png,1024,1430,647,345
2739,text,658,322,156,24,14_denoise.png,1024,1430,814,346
2740,text,445,411,144,20,14_denoise.png,1024,1430,589,431
2741,text,103,495,86,20,14_denoise.png,1024,1430,189,515
2742,text,284,494,100,26,14_denoise.png,1024,1430,384,520
2743,text,719,490,61,26,14_denoise.png,1024,1430,780,516
2744,text,851,493,98,20,14_denoise.png,1024,1430,949,513
2745,text,131,561,46,20,14_denoise.png,1024,1430,177,581
2746,text,242,558,420,26,14_denoise.png,1024,1430,662,584
2747,text,721,559,70,20,14_denoise.png,1024,1430,791,579
2748,text,871,559,70,20,14_denoise.png,1024,1430,941,579
2749,text,238,579,186,28,14_denoise.png,1024,1430,424,607
2750,text,238,602,424,26,14_denoise.png,1024,1430,662,628
2751,text,721,603,70,20,14_denoise.png,1024,1430,791,623
2752,text,871,603,70,20,14_denoise.png,1024,1430,941,623
2753,text,238,624,190,24,14_denoise.png,1024,1430,428,648
2754,text,623,827,72,20,14_denoise.png,1024,1430,695,847
2755,text,855,827,66,18,14_denoise.png,1024,1430,921,845
2756,text,621,853,84,20,14_denoise.png,1024,1430,705,873
2757,text,864,850,60,24,14_denoise.png,1024,1430,924,874
2758,text,621,879,78,20,14_denoise.png,1024,1430,699,899
2759,text,857,877,66,20,14_denoise.png,1024,1430,923,897
2760,text,74,1082,334,26,14_denoise.png,1024,1430,408,1108
2761,text,415,1085,164,20,14_denoise.png,1024,1430,579,1105
2762,text,34,1348,354,25,14_denoise.png,1024,1430,388,1373
2763,text,399,1353,52,16,14_denoise.png,1024,1430,451,1369
2764,text,457,1351,150,18,14_denoise.png,1024,1430,607,1369
2765,text,617,1351,264,20,14_denoise.png,1024,1430,881,1371
2766,text,32,1372,239,24,14_denoise.png,1024,1430,271,1396
2767,text,283,1370,185,26,14_denoise.png,1024,1430,468,1396
2768,text,479,1371,90,24,14_denoise.png,1024,1430,569,1395
2769,text,579,1371,141,27,14_denoise.png,1024,1430,720,1398
2770,text,730,1372,97,23,14_denoise.png,1024,1430,827,1395
2771,text,836,1371,115,27,14_denoise.png,1024,1430,951,1398
2772,text,203,85,366,42,14_median.png,1024,1430,569,127
2773,text,204,126,230,28,14_median.png,1024,1430,434,154
2774,text,454,128,112,26,14_median.png,1024,1430,566,154
2775,text,206,160,360,30,14_median.png,1024,1430,566,190
2776,text,116,301,118,24,14_median.png,1024,1430,234,325
2777,text,616,298,156,24,14_median.png,1024,1430,772,322
2778,text,615,325,32,20,14_median.png,1024,1430,647,345
2779,text,658,322,156,24,14_median.png,1024,1430,814,346
2780,text,445,411,144,20,14_median.png,1024,1430,589,431
2781,text,103,495,86,20,14_median.png,1024,1430,189,515
2782,text,284,494,100,26,14_median.png,1024,1430,384,520
2783,text,719,490,61,26,14_median.png,1024,1430,780,516
2784,text,851,493,98,20,14_median.png,1024,1430,949,513
2785,text,131,561,46,20,14_median.png,1024,1430,177,581
2786,text,242,558,420,26,14_median.png,1024,1430,662,584
2787,text,721,559,70,20,14_median.png,1024,1430,791,579
2788,text,871,559,70,20,14_median.png,1024,1430,941,579
2789,text,238,579,186,28,14_median.png,1024,1430,424,607
2790,text,238,602,424,26,14_median.png,1024,1430,662,628
2791,text,721,603,70,20,14_median.png,1024,1430,791,623
2792,text,871,603,70,20,14_median.png,1024,1430,941,623
2793,text,238,624,190,24,14_median.png,1024,1430,428,648
2794,text,623,827,72,20,14_median.png,1024,1430,695,847
2795,text,855,827,66,18,14_median.png,1024,1430,921,845
2796,text,621,853,84,20,14_median.png,1024,1430,705,873
2797,text,864,850,60,24,14_median.png,1024,1430,924,874
2798,text,621,879,78,20,14_median.png,1024,1430,699,899
2799,text,857,877,66,20,14_median.png,1024,1430,923,897
2800,text,74,1082,334,26,14_median.png,1024,1430,408,1108
2801,text,415,1085,164,20,14_median.png,1024,1430,579,1105
2802,text,34,1348,354,25,14_median.png,1024,1430,388,1373
2803,text,399,1353,52,16,14_median.png,1024,1430,451,1369
2804,text,457,1351,150,18,14_median.png,1024,1430,607,1369
2805,text,617,1351,264,20,14_median.png,1024,1430,881,1371
2806,text,32,1372,239,24,14_median.png,1024,1430,271,1396
2807,text,283,1370,185,26,14_median.png,1024,1430,468,1396
2808,text,479,1371,90,24,14_median.png,1024,1430,569,1395
2809,text,579,1371,141,27,14_median.png,1024,1430,720,1398
2810,text,730,1372,97,23,14_median.png,1024,1430,827,1395
2811,text,836,1371,115,27,14_median.png,1024,1430,951,1398
2812,text,233,53,204,64,15.png,1024,1448,437,117
2813,text,438,88,106,26,15.png,1024,1448,544,114
2814,text,63,293,151,27,15.png,1024,1448,214,320
2815,text,300,296,82,26,15.png,1024,1448,382,322
2816,text,682,298,170,30,15.png,1024,1448,852,328
2817,text,112,350,54,26,15.png,1024,1448,166,376
2818,text,275,349,132,28,15.png,1024,1448,407,377
2819,text,714,362,102,24,15.png,1024,1448,816,386
2820,text,662,392,202,26,15.png,1024,1448,864,418
2821,text,42,456,48,32,15.png,1024,1448,90,488
2822,text,238,458,142,30,15.png,1024,1448,380,488
2823,text,546,460,140,28,15.png,1024,1448,686,488
2824,text,722,462,52,28,15.png,1024,1448,774,490
2825,text,824,462,102,26,15.png,1024,1448,926,488
2826,text,53,511,22,20,15.png,1024,1448,75,531
2827,text,154,512,284,24,15.png,1024,1448,438,536
2828,text,628,514,74,24,15.png,1024,1448,702,538
2829,text,727,515,38,20,15.png,1024,1448,765,535
2830,text,860,516,94,24,15.png,1024,1448,954,540
2831,text,598,960,102,28,15.png,1024,1448,700,988
2832,text,853,961,94,20,15.png,1024,1448,947,981
2833,text,564,1006,170,30,15.png,1024,1448,734,1036
2834,text,863,1007,82,20,15.png,1024,1448,945,1027
2835,text,592,1054,112,30,15.png,1024,1448,704,1084
2836,text,850,1052,96,24,15.png,1024,1448,946,1076
2837,text,157,1316,319,21,15.png,1024,1448,476,1337
2838,text,489,1319,42,20,15.png,1024,1448,531,1339
2839,text,706,1321,157,20,15.png,1024,1448,863,1341
2840,text,196,1338,128,19,15.png,1024,1448,324,1357
2841,text,567,1341,82,20,15.png,1024,1448,649,1361
2842,text,293,1359,246,20,15.png,1024,1448,539,1379
2843,text,539,1320,166,19,15.png,1024,1448,705,1339
2844,text,332,1338,93,20,15.png,1024,1448,425,1358
2845,text,430,1340,130,18,15.png,1024,1448,560,1358
2846,text,657,1339,95,19,15.png,1024,1448,752,1358
2847,text,233,53,204,64,15_contrasted.png,1024,1448,437,117
2848,text,438,88,106,26,15_contrasted.png,1024,1448,544,114
2849,text,63,293,151,27,15_contrasted.png,1024,1448,214,320
2850,text,300,296,82,26,15_contrasted.png,1024,1448,382,322
2851,text,682,298,170,30,15_contrasted.png,1024,1448,852,328
2852,text,112,350,54,26,15_contrasted.png,1024,1448,166,376
2853,text,275,349,132,28,15_contrasted.png,1024,1448,407,377
2854,text,714,362,102,24,15_contrasted.png,1024,1448,816,386
2855,text,662,392,202,26,15_contrasted.png,1024,1448,864,418
2856,text,42,456,48,32,15_contrasted.png,1024,1448,90,488
2857,text,238,458,142,30,15_contrasted.png,1024,1448,380,488
2858,text,546,460,140,28,15_contrasted.png,1024,1448,686,488
2859,text,722,462,52,28,15_contrasted.png,1024,1448,774,490
2860,text,824,462,102,26,15_contrasted.png,1024,1448,926,488
2861,text,53,511,22,20,15_contrasted.png,1024,1448,75,531
2862,text,154,512,284,24,15_contrasted.png,1024,1448,438,536
2863,text,628,514,74,24,15_contrasted.png,1024,1448,702,538
2864,text,727,515,38,20,15_contrasted.png,1024,1448,765,535
2865,text,860,516,94,24,15_contrasted.png,1024,1448,954,540
2866,text,598,960,102,28,15_contrasted.png,1024,1448,700,988
2867,text,853,961,94,20,15_contrasted.png,1024,1448,947,981
2868,text,564,1006,170,30,15_contrasted.png,1024,1448,734,1036
2869,text,863,1007,82,20,15_contrasted.png,1024,1448,945,1027
2870,text,592,1054,112,30,15_contrasted.png,1024,1448,704,1084
2871,text,850,1052,96,24,15_contrasted.png,1024,1448,946,1076
2872,text,157,1316,319,21,15_contrasted.png,1024,1448,476,1337
2873,text,489,1319,42,20,15_contrasted.png,1024,1448,531,1339
2874,text,706,1321,157,20,15_contrasted.png,1024,1448,863,1341
2875,text,196,1338,128,19,15_contrasted.png,1024,1448,324,1357
2876,text,567,1341,82,20,15_contrasted.png,1024,1448,649,1361
2877,text,293,1359,246,20,15_contrasted.png,1024,1448,539,1379
2878,text,539,1320,166,19,15_contrasted.png,1024,1448,705,1339
2879,text,332,1338,93,20,15_contrasted.png,1024,1448,425,1358
2880,text,430,1340,130,18,15_contrasted.png,1024,1448,560,1358
2881,text,657,1339,95,19,15_contrasted.png,1024,1448,752,1358
2882,text,233,53,204,64,15_denoise.png,1024,1448,437,117
2883,text,438,88,106,26,15_denoise.png,1024,1448,544,114
2884,text,63,293,151,27,15_denoise.png,1024,1448,214,320
2885,text,300,296,82,26,15_denoise.png,1024,1448,382,322
2886,text,682,298,170,30,15_denoise.png,1024,1448,852,328
2887,text,112,350,54,26,15_denoise.png,1024,1448,166,376
2888,text,275,349,132,28,15_denoise.png,1024,1448,407,377
2889,text,714,362,102,24,15_denoise.png,1024,1448,816,386
2890,text,662,392,202,26,15_denoise.png,1024,1448,864,418
2891,text,42,456,48,32,15_denoise.png,1024,1448,90,488
2892,text,238,458,142,30,15_denoise.png,1024,1448,380,488
2893,text,546,460,140,28,15_denoise.png,1024,1448,686,488
2894,text,722,462,52,28,15_denoise.png,1024,1448,774,490
2895,text,824,462,102,26,15_denoise.png,1024,1448,926,488
2896,text,53,511,22,20,15_denoise.png,1024,1448,75,531
2897,text,154,512,284,24,15_denoise.png,1024,1448,438,536
2898,text,628,514,74,24,15_denoise.png,1024,1448,702,538
2899,text,727,515,38,20,15_denoise.png,1024,1448,765,535
2900,text,860,516,94,24,15_denoise.png,1024,1448,954,540
2901,text,598,960,102,28,15_denoise.png,1024,1448,700,988
2902,text,853,961,94,20,15_denoise.png,1024,1448,947,981
2903,text,564,1006,170,30,15_denoise.png,1024,1448,734,1036
2904,text,863,1007,82,20,15_denoise.png,1024,1448,945,1027
2905,text,592,1054,112,30,15_denoise.png,1024,1448,704,1084
2906,text,850,1052,96,24,15_denoise.png,1024,1448,946,1076
2907,text,157,1316,319,21,15_denoise.png,1024,1448,476,1337
2908,text,489,1319,42,20,15_denoise.png,1024,1448,531,1339
2909,text,706,1321,157,20,15_denoise.png,1024,1448,863,1341
2910,text,196,1338,128,19,15_denoise.png,1024,1448,324,1357
2911,text,567,1341,82,20,15_denoise.png,1024,1448,649,1361
2912,text,293,1359,246,20,15_denoise.png,1024,1448,539,1379
2913,text,539,1320,166,19,15_denoise.png,1024,1448,705,1339
2914,text,332,1338,93,20,15_denoise.png,1024,1448,425,1358
2915,text,430,1340,130,18,15_denoise.png,1024,1448,560,1358
2916,text,657,1339,95,19,15_denoise.png,1024,1448,752,1358
2917,text,233,53,204,64,15_median.png,1024,1448,437,117
2918,text,438,88,106,26,15_median.png,1024,1448,544,114
2919,text,63,293,151,27,15_median.png,1024,1448,214,320
2920,text,300,296,82,26,15_median.png,1024,1448,382,322
2921,text,682,298,170,30,15_median.png,1024,1448,852,328
2922,text,112,350,54,26,15_median.png,1024,1448,166,376
2923,text,275,349,132,28,15_median.png,1024,1448,407,377
2924,text,714,362,102,24,15_median.png,1024,1448,816,386
2925,text,662,392,202,26,15_median.png,1024,1448,864,418
2926,text,42,456,48,32,15_median.png,1024,1448,90,488
2927,text,238,458,142,30,15_median.png,1024,1448,380,488
2928,text,546,460,140,28,15_median.png,1024,1448,686,488
2929,text,722,462,52,28,15_median.png,1024,1448,774,490
2930,text,824,462,102,26,15_median.png,1024,1448,926,488
2931,text,53,511,22,20,15_median.png,1024,1448,75,531
2932,text,154,512,284,24,15_median.png,1024,1448,438,536
2933,text,628,514,74,24,15_median.png,1024,1448,702,538
2934,text,727,515,38,20,15_median.png,1024,1448,765,535
2935,text,860,516,94,24,15_median.png,1024,1448,954,540
2936,text,598,960,102,28,15_median.png,1024,1448,700,988
2937,text,853,961,94,20,15_median.png,1024,1448,947,981
2938,text,564,1006,170,30,15_median.png,1024,1448,734,1036
2939,text,863,1007,82,20,15_median.png,1024,1448,945,1027
2940,text,592,1054,112,30,15_median.png,1024,1448,704,1084
2941,text,850,1052,96,24,15_median.png,1024,1448,946,1076
2942,text,157,1316,319,21,15_median.png,1024,1448,476,1337
2943,text,489,1319,42,20,15_median.png,1024,1448,531,1339
2944,text,706,1321,157,20,15_median.png,1024,1448,863,1341
2945,text,196,1338,128,19,15_median.png,1024,1448,324,1357
2946,text,567,1341,82,20,15_median.png,1024,1448,649,1361
2947,text,293,1359,246,20,15_median.png,1024,1448,539,1379
2948,text,539,1320,166,19,15_median.png,1024,1448,705,1339
2949,text,332,1338,93,20,15_median.png,1024,1448,425,1358
2950,text,430,1340,130,18,15_median.png,1024,1448,560,1358
2951,text,657,1339,95,19,15_median.png,1024,1448,752,1358
2952,text,118,83,189,62,16.png,1024,1430,307,145
2953,text,619,110,245,32,16.png,1024,1430,864,142
2954,text,715,193,44,16,16.png,1024,1430,759,209
2955,text,695,213,82,18,16.png,1024,1430,777,231
2956,text,689,235,96,16,16.png,1024,1430,785,251
2957,text,663,255,146,18,16.png,1024,1430,809,273
2958,text,691,277,42,16,16.png,1024,1430,733,293
2959,text,743,279,38,14,16.png,1024,1430,781,293
2960,text,125,319,70,16,16.png,1024,1430,195,335
2961,text,223,318,130,16,16.png,1024,1430,353,334
2962,text,127,341,34,14,16.png,1024,1430,161,355
2963,text,222,336,204,24,16.png,1024,1430,426,360
2964,text,127,361,68,16,16.png,1024,1430,195,377
2965,text,221,359,124,18,16.png,1024,1430,345,377
2966,text,125,383,54,16,16.png,1024,1430,179,399
2967,text,223,383,72,16,16.png,1024,1430,295,399
2968,text,235,489,82,18,16.png,1024,1430,317,507
2969,text,449,491,36,18,16.png,1024,1430,485,509
2970,text,515,487,62,20,16.png,1024,1430,577,507
2971,text,625,487,60,20,16.png,1024,1430,685,507
2972,text,764,486,76,24,16.png,1024,1430,840,510
2973,text,155,529,240,20,16.png,1024,1430,395,549
2974,text,449,533,40,18,16.png,1024,1430,489,551
2975,text,655,529,68,18,16.png,1024,1430,723,547
2976,text,803,529,74,18,16.png,1024,1430,877,547
2977,text,595,763,110,20,16.png,1024,1430,705,783
2978,text,801,765,74,16,16.png,1024,1430,875,781
2979,text,595,783,110,20,16.png,1024,1430,705,803
2980,text,801,785,74,18,16.png,1024,1430,875,803
2981,text,591,805,118,20,16.png,1024,1430,709,825
2982,text,801,809,74,16,16.png,1024,1430,875,825
2983,text,119,871,278,18,16.png,1024,1430,397,889
2984,text,310,889,269,21,16.png,1024,1430,579,910
2985,text,197,977,142,18,16.png,1024,1430,339,995
2986,text,187,1001,23,14,16.png,1024,1430,210,1015
2987,text,215,1001,194,16,16.png,1024,1430,409,1017
2988,text,167,1021,124,16,16.png,1024,1430,291,1037
2989,text,202,1084,129,20,16.png,1024,1430,331,1104
2990,text,113,1213,170,18,16.png,1024,1430,283,1231
2991,text,439,1277,102,14,16.png,1024,1430,541,1291
2992,text,307,1289,289,14,16.png,1024,1430,596,1303
2993,text,599,1291,74,12,16.png,1024,1430,673,1303
2994,text,361,1302,122,13,16.png,1024,1430,483,1315
2995,text,489,1303,58,12,16.png,1024,1430,547,1315
2996,text,554,1303,63,14,16.png,1024,1430,617,1317
2997,text,520,527,42,17,16.png,1024,1430,562,544
2998,text,118,83,189,62,16_contrasted.png,1024,1430,307,145
2999,text,619,110,245,32,16_contrasted.png,1024,1430,864,142
3000,text,715,193,44,16,16_contrasted.png,1024,1430,759,209
3001,text,695,213,82,18,16_contrasted.png,1024,1430,777,231
3002,text,689,235,96,16,16_contrasted.png,1024,1430,785,251
3003,text,663,255,146,18,16_contrasted.png,1024,1430,809,273
3004,text,691,277,42,16,16_contrasted.png,1024,1430,733,293
3005,text,743,279,38,14,16_contrasted.png,1024,1430,781,293
3006,text,125,319,70,16,16_contrasted.png,1024,1430,195,335
3007,text,223,318,130,16,16_contrasted.png,1024,1430,353,334
3008,text,127,341,34,14,16_contrasted.png,1024,1430,161,355
3009,text,222,336,204,24,16_contrasted.png,1024,1430,426,360
3010,text,127,361,68,16,16_contrasted.png,1024,1430,195,377
3011,text,221,359,124,18,16_contrasted.png,1024,1430,345,377
3012,text,125,383,54,16,16_contrasted.png,1024,1430,179,399
3013,text,223,383,72,16,16_contrasted.png,1024,1430,295,399
3014,text,235,489,82,18,16_contrasted.png,1024,1430,317,507
3015,text,449,491,36,18,16_contrasted.png,1024,1430,485,509
3016,text,515,487,62,20,16_contrasted.png,1024,1430,577,507
3017,text,625,487,60,20,16_contrasted.png,1024,1430,685,507
3018,text,764,486,76,24,16_contrasted.png,1024,1430,840,510
3019,text,155,529,240,20,16_contrasted.png,1024,1430,395,549
3020,text,449,533,40,18,16_contrasted.png,1024,1430,489,551
3021,text,655,529,68,18,16_contrasted.png,1024,1430,723,547
3022,text,803,529,74,18,16_contrasted.png,1024,1430,877,547
3023,text,595,763,110,20,16_contrasted.png,1024,1430,705,783
3024,text,801,765,74,16,16_contrasted.png,1024,1430,875,781
3025,text,595,783,110,20,16_contrasted.png,1024,1430,705,803
3026,text,801,785,74,18,16_contrasted.png,1024,1430,875,803
3027,text,591,805,118,20,16_contrasted.png,1024,1430,709,825
3028,text,801,809,74,16,16_contrasted.png,1024,1430,875,825
3029,text,119,871,278,18,16_contrasted.png,1024,1430,397,889
3030,text,310,889,269,21,16_contrasted.png,1024,1430,579,910
3031,text,197,977,142,18,16_contrasted.png,1024,1430,339,995
3032,text,187,1001,23,14,16_contrasted.png,1024,1430,210,1015
3033,text,215,1001,194,16,16_contrasted.png,1024,1430,409,1017
3034,text,167,1021,124,16,16_contrasted.png,1024,1430,291,1037
3035,text,202,1084,129,20,16_contrasted.png,1024,1430,331,1104
3036,text,113,1213,170,18,16_contrasted.png,1024,1430,283,1231
3037,text,439,1277,102,14,16_contrasted.png,1024,1430,541,1291
3038,text,307,1289,289,14,16_contrasted.png,1024,1430,596,1303
3039,text,599,1291,74,12,16_contrasted.png,1024,1430,673,1303
3040,text,361,1302,122,13,16_contrasted.png,1024,1430,483,1315
3041,text,489,1303,58,12,16_contrasted.png,1024,1430,547,1315
3042,text,554,1303,63,14,16_contrasted.png,1024,1430,617,1317
3043,text,520,527,42,17,16_contrasted.png,1024,1430,562,544
3044,text,118,83,189,62,16_denoise.png,1024,1430,307,145
3045,text,619,110,245,32,16_denoise.png,1024,1430,864,142
3046,text,715,193,44,16,16_denoise.png,1024,1430,759,209
3047,text,695,213,82,18,16_denoise.png,1024,1430,777,231
3048,text,689,235,96,16,16_denoise.png,1024,1430,785,251
3049,text,663,255,146,18,16_denoise.png,1024,1430,809,273
3050,text,691,277,42,16,16_denoise.png,1024,1430,733,293
3051,text,743,279,38,14,16_denoise.png,1024,1430,781,293
3052,text,125,319,70,16,16_denoise.png,1024,1430,195,335
3053,text,223,318,130,16,16_denoise.png,1024,1430,353,334
3054,text,127,341,34,14,16_denoise.png,1024,1430,161,355
3055,text,222,336,204,24,16_denoise.png,1024,1430,426,360
3056,text,127,361,68,16,16_denoise.png,1024,1430,195,377
3057,text,221,359,124,18,16_denoise.png,1024,1430,345,377
3058,text,125,383,54,16,16_denoise.png,1024,1430,179,399
3059,text,223,383,72,16,16_denoise.png,1024,1430,295,399
3060,text,235,489,82,18,16_denoise.png,1024,1430,317,507
3061,text,449,491,36,18,16_denoise.png,1024,1430,485,509
3062,text,515,487,62,20,16_denoise.png,1024,1430,577,507
3063,text,625,487,60,20,16_denoise.png,1024,1430,685,507
3064,text,764,486,76,24,16_denoise.png,1024,1430,840,510
3065,text,155,529,240,20,16_denoise.png,1024,1430,395,549
3066,text,449,533,40,18,16_denoise.png,1024,1430,489,551
3067,text,655,529,68,18,16_denoise.png,1024,1430,723,547
3068,text,803,529,74,18,16_denoise.png,1024,1430,877,547
3069,text,595,763,110,20,16_denoise.png,1024,1430,705,783
3070,text,801,765,74,16,16_denoise.png,1024,1430,875,781
3071,text,595,783,110,20,16_denoise.png,1024,1430,705,803
3072,text,801,785,74,18,16_denoise.png,1024,1430,875,803
3073,text,591,805,118,20,16_denoise.png,1024,1430,709,825
3074,text,801,809,74,16,16_denoise.png,1024,1430,875,825
3075,text,119,871,278,18,16_denoise.png,1024,1430,397,889
3076,text,310,889,269,21,16_denoise.png,1024,1430,579,910
3077,text,197,977,142,18,16_denoise.png,1024,1430,339,995
3078,text,187,1001,23,14,16_denoise.png,1024,1430,210,1015
3079,text,215,1001,194,16,16_denoise.png,1024,1430,409,1017
3080,text,167,1021,124,16,16_denoise.png,1024,1430,291,1037
3081,text,202,1084,129,20,16_denoise.png,1024,1430,331,1104
3082,text,113,1213,170,18,16_denoise.png,1024,1430,283,1231
3083,text,439,1277,102,14,16_denoise.png,1024,1430,541,1291
3084,text,307,1289,289,14,16_denoise.png,1024,1430,596,1303
3085,text,599,1291,74,12,16_denoise.png,1024,1430,673,1303
3086,text,361,1302,122,13,16_denoise.png,1024,1430,483,1315
3087,text,489,1303,58,12,16_denoise.png,1024,1430,547,1315
3088,text,554,1303,63,14,16_denoise.png,1024,1430,617,1317
3089,text,520,527,42,17,16_denoise.png,1024,1430,562,544
3090,text,118,83,189,62,16_median.png,1024,1430,307,145
3091,text,619,110,245,32,16_median.png,1024,1430,864,142
3092,text,715,193,44,16,16_median.png,1024,1430,759,209
3093,text,695,213,82,18,16_median.png,1024,1430,777,231
3094,text,689,235,96,16,16_median.png,1024,1430,785,251
3095,text,663,255,146,18,16_median.png,1024,1430,809,273
3096,text,691,277,42,16,16_median.png,1024,1430,733,293
3097,text,743,279,38,14,16_median.png,1024,1430,781,293
3098,text,125,319,70,16,16_median.png,1024,1430,195,335
3099,text,223,318,130,16,16_median.png,1024,1430,353,334
3100,text,127,341,34,14,16_median.png,1024,1430,161,355
3101,text,222,336,204,24,16_median.png,1024,1430,426,360
3102,text,127,361,68,16,16_median.png,1024,1430,195,377
3103,text,221,359,124,18,16_median.png,1024,1430,345,377
3104,text,125,383,54,16,16_median.png,1024,1430,179,399
3105,text,223,383,72,16,16_median.png,1024,1430,295,399
3106,text,235,489,82,18,16_median.png,1024,1430,317,507
3107,text,449,491,36,18,16_median.png,1024,1430,485,509
3108,text,515,487,62,20,16_median.png,1024,1430,577,507
3109,text,625,487,60,20,16_median.png,1024,1430,685,507
3110,text,764,486,76,24,16_median.png,1024,1430,840,510
3111,text,155,529,240,20,16_median.png,1024,1430,395,549
3112,text,449,533,40,18,16_median.png,1024,1430,489,551
3113,text,655,529,68,18,16_median.png,1024,1430,723,547
3114,text,803,529,74,18,16_median.png,1024,1430,877,547
3115,text,595,763,110,20,16_median.png,1024,1430,705,783
3116,text,801,765,74,16,16_median.png,1024,1430,875,781
3117,text,595,783,110,20,16_median.png,1024,1430,705,803
3118,text,801,785,74,18,16_median.png,1024,1430,875,803
3119,text,591,805,118,20,16_median.png,1024,1430,709,825
3120,text,801,809,74,16,16_median.png,1024,1430,875,825
3121,text,119,871,278,18,16_median.png,1024,1430,397,889
3122,text,310,889,269,21,16_median.png,1024,1430,579,910
3123,text,197,977,142,18,16_median.png,1024,1430,339,995
3124,text,187,1001,23,14,16_median.png,1024,1430,210,1015
3125,text,215,1001,194,16,16_median.png,1024,1430,409,1017
3126,text,167,1021,124,16,16_median.png,1024,1430,291,1037
3127,text,202,1084,129,20,16_median.png,1024,1430,331,1104
3128,text,113,1213,170,18,16_median.png,1024,1430,283,1231
3129,text,439,1277,102,14,16_median.png,1024,1430,541,1291
3130,text,307,1289,289,14,16_median.png,1024,1430,596,1303
3131,text,599,1291,74,12,16_median.png,1024,1430,673,1303
3132,text,361,1302,122,13,16_median.png,1024,1430,483,1315
3133,text,489,1303,58,12,16_median.png,1024,1430,547,1315
3134,text,554,1303,63,14,16_median.png,1024,1430,617,1317
3135,text,520,527,42,17,16_median.png,1024,1430,562,544
3136,text,72,270,200,32,17.png,1024,1430,272,302
3137,text,282,270,70,30,17.png,1024,1430,352,300
3138,text,133,305,360,38,17.png,1024,1430,493,343
3139,text,485,349,38,16,17.png,1024,1430,523,365
3140,text,531,345,92,20,17.png,1024,1430,623,365
3141,text,393,397,254,20,17.png,1024,1430,647,417
3142,text,579,443,104,20,17.png,1024,1430,683,463
3143,text,386,492,182,24,17.png,1024,1430,568,516
3144,text,389,519,46,20,17.png,1024,1430,435,539
3145,text,483,519,50,18,17.png,1024,1430,533,537
3146,text,649,517,80,20,17.png,1024,1430,729,537
3147,text,35,637,87,24,17.png,1024,1430,122,661
3148,text,133,638,101,24,17.png,1024,1430,234,662
3149,text,418,636,56,24,17.png,1024,1430,474,660
3150,text,569,637,74,20,17.png,1024,1430,643,657
3151,text,681,637,100,20,17.png,1024,1430,781,657
3152,text,830,634,86,24,17.png,1024,1430,916,658
3153,text,131,689,246,20,17.png,1024,1430,377,709
3154,text,33,725,58,20,17.png,1024,1430,91,745
3155,text,130,712,244,26,17.png,1024,1430,374,738
3156,text,397,723,76,20,17.png,1024,1430,473,743
3157,text,703,721,78,20,17.png,1024,1430,781,741
3158,text,845,721,56,20,17.png,1024,1430,901,741
3159,text,130,735,244,29,17.png,1024,1430,374,764
3160,text,394,992,72,24,17.png,1024,1430,466,1016
3161,text,547,1005,28,20,17.png,1024,1430,575,1025
3162,text,701,1005,80,20,17.png,1024,1430,781,1025
3163,text,415,1017,32,20,17.png,1024,1430,447,1037
3164,text,539,1041,42,20,17.png,1024,1430,581,1061
3165,text,674,1038,106,24,17.png,1024,1430,780,1062
3166,text,521,1099,76,18,17.png,1024,1430,597,1117
3167,text,701,1097,78,20,17.png,1024,1430,779,1117
3168,text,256,1172,490,26,17.png,1024,1430,746,1198
3169,text,170,1334,94,24,17.png,1024,1430,264,1358
3170,text,268,1331,536,24,17.png,1024,1430,804,1355
3171,text,166,1356,107,22,17.png,1024,1430,273,1378
3172,text,625,1354,183,19,17.png,1024,1430,808,1373
3173,text,553,721,17,21,17.png,1024,1430,570,742
3174,text,281,1356,115,23,17.png,1024,1430,396,1379
3175,text,395,1354,99,26,17.png,1024,1430,494,1380
3176,text,499,1354,125,21,17.png,1024,1430,624,1375
3177,text,72,270,200,32,17_contrasted.png,1024,1430,272,302
3178,text,282,270,70,30,17_contrasted.png,1024,1430,352,300
3179,text,133,305,360,38,17_contrasted.png,1024,1430,493,343
3180,text,485,349,38,16,17_contrasted.png,1024,1430,523,365
3181,text,531,345,92,20,17_contrasted.png,1024,1430,623,365
3182,text,393,397,254,20,17_contrasted.png,1024,1430,647,417
3183,text,579,443,104,20,17_contrasted.png,1024,1430,683,463
3184,text,386,492,182,24,17_contrasted.png,1024,1430,568,516
3185,text,389,519,46,20,17_contrasted.png,1024,1430,435,539
3186,text,483,519,50,18,17_contrasted.png,1024,1430,533,537
3187,text,649,517,80,20,17_contrasted.png,1024,1430,729,537
3188,text,35,637,87,24,17_contrasted.png,1024,1430,122,661
3189,text,133,638,101,24,17_contrasted.png,1024,1430,234,662
3190,text,418,636,56,24,17_contrasted.png,1024,1430,474,660
3191,text,569,637,74,20,17_contrasted.png,1024,1430,643,657
3192,text,681,637,100,20,17_contrasted.png,1024,1430,781,657
3193,text,830,634,86,24,17_contrasted.png,1024,1430,916,658
3194,text,131,689,246,20,17_contrasted.png,1024,1430,377,709
3195,text,33,725,58,20,17_contrasted.png,1024,1430,91,745
3196,text,130,712,244,26,17_contrasted.png,1024,1430,374,738
3197,text,397,723,76,20,17_contrasted.png,1024,1430,473,743
3198,text,703,721,78,20,17_contrasted.png,1024,1430,781,741
3199,text,845,721,56,20,17_contrasted.png,1024,1430,901,741
3200,text,130,735,244,29,17_contrasted.png,1024,1430,374,764
3201,text,394,992,72,24,17_contrasted.png,1024,1430,466,1016
3202,text,547,1005,28,20,17_contrasted.png,1024,1430,575,1025
3203,text,701,1005,80,20,17_contrasted.png,1024,1430,781,1025
3204,text,415,1017,32,20,17_contrasted.png,1024,1430,447,1037
3205,text,539,1041,42,20,17_contrasted.png,1024,1430,581,1061
3206,text,674,1038,106,24,17_contrasted.png,1024,1430,780,1062
3207,text,521,1099,76,18,17_contrasted.png,1024,1430,597,1117
3208,text,701,1097,78,20,17_contrasted.png,1024,1430,779,1117
3209,text,256,1172,490,26,17_contrasted.png,1024,1430,746,1198
3210,text,170,1334,94,24,17_contrasted.png,1024,1430,264,1358
3211,text,268,1331,536,24,17_contrasted.png,1024,1430,804,1355
3212,text,166,1356,107,22,17_contrasted.png,1024,1430,273,1378
3213,text,625,1354,183,19,17_contrasted.png,1024,1430,808,1373
3214,text,553,721,17,21,17_contrasted.png,1024,1430,570,742
3215,text,281,1356,115,23,17_contrasted.png,1024,1430,396,1379
3216,text,395,1354,99,26,17_contrasted.png,1024,1430,494,1380
3217,text,499,1354,125,21,17_contrasted.png,1024,1430,624,1375
3218,text,72,270,200,32,17_denoise.png,1024,1430,272,302
3219,text,282,270,70,30,17_denoise.png,1024,1430,352,300
3220,text,133,305,360,38,17_denoise.png,1024,1430,493,343
3221,text,485,349,38,16,17_denoise.png,1024,1430,523,365
3222,text,531,345,92,20,17_denoise.png,1024,1430,623,365
3223,text,393,397,254,20,17_denoise.png,1024,1430,647,417
3224,text,579,443,104,20,17_denoise.png,1024,1430,683,463
3225,text,386,492,182,24,17_denoise.png,1024,1430,568,516
3226,text,389,519,46,20,17_denoise.png,1024,1430,435,539
3227,text,483,519,50,18,17_denoise.png,1024,1430,533,537
3228,text,649,517,80,20,17_denoise.png,1024,1430,729,537
3229,text,35,637,87,24,17_denoise.png,1024,1430,122,661
3230,text,133,638,101,24,17_denoise.png,1024,1430,234,662
3231,text,418,636,56,24,17_denoise.png,1024,1430,474,660
3232,text,569,637,74,20,17_denoise.png,1024,1430,643,657
3233,text,681,637,100,20,17_denoise.png,1024,1430,781,657
3234,text,830,634,86,24,17_denoise.png,1024,1430,916,658
3235,text,131,689,246,20,17_denoise.png,1024,1430,377,709
3236,text,33,725,58,20,17_denoise.png,1024,1430,91,745
3237,text,130,712,244,26,17_denoise.png,1024,1430,374,738
3238,text,397,723,76,20,17_denoise.png,1024,1430,473,743
3239,text,703,721,78,20,17_denoise.png,1024,1430,781,741
3240,text,845,721,56,20,17_denoise.png,1024,1430,901,741
3241,text,130,735,244,29,17_denoise.png,1024,1430,374,764
3242,text,394,992,72,24,17_denoise.png,1024,1430,466,1016
3243,text,547,1005,28,20,17_denoise.png,1024,1430,575,1025
3244,text,701,1005,80,20,17_denoise.png,1024,1430,781,1025
3245,text,415,1017,32,20,17_denoise.png,1024,1430,447,1037
3246,text,539,1041,42,20,17_denoise.png,1024,1430,581,1061
3247,text,674,1038,106,24,17_denoise.png,1024,1430,780,1062
3248,text,521,1099,76,18,17_denoise.png,1024,1430,597,1117
3249,text,701,1097,78,20,17_denoise.png,1024,1430,779,1117
3250,text,256,1172,490,26,17_denoise.png,1024,1430,746,1198
3251,text,170,1334,94,24,17_denoise.png,1024,1430,264,1358
3252,text,268,1331,536,24,17_denoise.png,1024,1430,804,1355
3253,text,166,1356,107,22,17_denoise.png,1024,1430,273,1378
3254,text,625,1354,183,19,17_denoise.png,1024,1430,808,1373
3255,text,553,721,17,21,17_denoise.png,1024,1430,570,742
3256,text,281,1356,115,23,17_denoise.png,1024,1430,396,1379
3257,text,395,1354,99,26,17_denoise.png,1024,1430,494,1380
3258,text,499,1354,125,21,17_denoise.png,1024,1430,624,1375
3259,text,72,270,200,32,17_median.png,1024,1430,272,302
3260,text,282,270,70,30,17_median.png,1024,1430,352,300
3261,text,133,305,360,38,17_median.png,1024,1430,493,343
3262,text,485,349,38,16,17_median.png,1024,1430,523,365
3263,text,531,345,92,20,17_median.png,1024,1430,623,365
3264,text,393,397,254,20,17_median.png,1024,1430,647,417
3265,text,579,443,104,20,17_median.png,1024,1430,683,463
3266,text,386,492,182,24,17_median.png,1024,1430,568,516
3267,text,389,519,46,20,17_median.png,1024,1430,435,539
3268,text,483,519,50,18,17_median.png,1024,1430,533,537
3269,text,649,517,80,20,17_median.png,1024,1430,729,537
3270,text,35,637,87,24,17_median.png,1024,1430,122,661
3271,text,133,638,101,24,17_median.png,1024,1430,234,662
3272,text,418,636,56,24,17_median.png,1024,1430,474,660
3273,text,569,637,74,20,17_median.png,1024,1430,643,657
3274,text,681,637,100,20,17_median.png,1024,1430,781,657
3275,text,830,634,86,24,17_median.png,1024,1430,916,658
3276,text,131,689,246,20,17_median.png,1024,1430,377,709
3277,text,33,725,58,20,17_median.png,1024,1430,91,745
3278,text,130,712,244,26,17_median.png,1024,1430,374,738
3279,text,397,723,76,20,17_median.png,1024,1430,473,743
3280,text,703,721,78,20,17_median.png,1024,1430,781,741
3281,text,845,721,56,20,17_median.png,1024,1430,901,741
3282,text,130,735,244,29,17_median.png,1024,1430,374,764
3283,text,394,992,72,24,17_median.png,1024,1430,466,1016
3284,text,547,1005,28,20,17_median.png,1024,1430,575,1025
3285,text,701,1005,80,20,17_median.png,1024,1430,781,1025
3286,text,415,1017,32,20,17_median.png,1024,1430,447,1037
3287,text,539,1041,42,20,17_median.png,1024,1430,581,1061
3288,text,674,1038,106,24,17_median.png,1024,1430,780,1062
3289,text,521,1099,76,18,17_median.png,1024,1430,597,1117
3290,text,701,1097,78,20,17_median.png,1024,1430,779,1117
3291,text,256,1172,490,26,17_median.png,1024,1430,746,1198
3292,text,170,1334,94,24,17_median.png,1024,1430,264,1358
3293,text,268,1331,536,24,17_median.png,1024,1430,804,1355
3294,text,166,1356,107,22,17_median.png,1024,1430,273,1378
3295,text,625,1354,183,19,17_median.png,1024,1430,808,1373
3296,text,553,721,17,21,17_median.png,1024,1430,570,742
3297,text,281,1356,115,23,17_median.png,1024,1430,396,1379
3298,text,395,1354,99,26,17_median.png,1024,1430,494,1380
3299,text,499,1354,125,21,17_median.png,1024,1430,624,1375
3300,text,418,39,398,48,18.png,1024,1448,816,87
3301,text,295,104,248,50,18.png,1024,1448,543,154
3302,text,565,102,204,48,18.png,1024,1448,769,150
3303,text,795,101,172,42,18.png,1024,1448,967,143
3304,text,587,149,92,38,18.png,1024,1448,679,187
3305,text,43,245,56,16,18.png,1024,1448,99,261
3306,text,177,243,34,16,18.png,1024,1448,211,259
3307,text,556,242,212,24,18.png,1024,1448,768,266
3308,text,40,280,74,24,18.png,1024,1448,114,304
3309,text,172,278,82,24,18.png,1024,1448,254,302
3310,text,47,327,72,16,18.png,1024,1448,119,343
3311,text,555,323,42,20,18.png,1024,1448,597,343
3312,text,556,340,160,24,18.png,1024,1448,716,364
3313,text,30,418,152,48,18.png,1024,1448,182,466
3314,text,617,523,26,16,18.png,1024,1448,643,539
3315,text,733,521,72,16,18.png,1024,1448,805,537
3316,text,881,517,86,20,18.png,1024,1448,967,537
3317,text,46,526,85,20,18.png,1024,1448,131,546
3318,text,44,552,126,24,18.png,1024,1448,170,576
3319,text,609,549,36,20,18.png,1024,1448,645,569
3320,text,753,549,52,18,18.png,1024,1448,805,567
3321,text,907,547,54,20,18.png,1024,1448,961,567
3322,text,44,574,126,24,18.png,1024,1448,170,598
3323,text,611,571,34,20,18.png,1024,1448,645,591
3324,text,753,569,52,20,18.png,1024,1448,805,589
3325,text,909,569,52,20,18.png,1024,1448,961,589
3326,text,45,597,104,20,18.png,1024,1448,149,617
3327,text,609,593,36,20,18.png,1024,1448,645,613
3328,text,753,591,52,20,18.png,1024,1448,805,611
3329,text,909,591,52,20,18.png,1024,1448,961,611
3330,text,45,619,126,20,18.png,1024,1448,171,639
3331,text,609,615,36,20,18.png,1024,1448,645,635
3332,text,751,613,54,20,18.png,1024,1448,805,633
3333,text,907,613,54,20,18.png,1024,1448,961,633
3334,text,45,641,122,20,18.png,1024,1448,167,661
3335,text,609,637,36,20,18.png,1024,1448,645,657
3336,text,751,635,54,20,18.png,1024,1448,805,655
3337,text,909,633,52,20,18.png,1024,1448,961,653
3338,text,44,660,156,24,18.png,1024,1448,200,684
3339,text,611,661,34,16,18.png,1024,1448,645,677
3340,text,751,657,54,20,18.png,1024,1448,805,677
3341,text,907,655,54,20,18.png,1024,1448,961,675
3342,text,45,685,92,20,18.png,1024,1448,137,705
3343,text,609,679,36,20,18.png,1024,1448,645,699
3344,text,751,677,54,20,18.png,1024,1448,805,697
3345,text,907,677,54,20,18.png,1024,1448,961,697
3346,text,44,704,171,21,18.png,1024,1448,215,725
3347,text,609,701,36,20,18.png,1024,1448,645,721
3348,text,751,699,54,20,18.png,1024,1448,805,719
3349,text,907,699,54,18,18.png,1024,1448,961,717
3350,text,44,723,129,25,18.png,1024,1448,173,748
3351,text,611,725,34,18,18.png,1024,1448,645,743
3352,text,751,721,54,20,18.png,1024,1448,805,741
3353,text,907,719,54,20,18.png,1024,1448,961,739
3354,text,45,1053,38,14,18.png,1024,1448,83,1067
3355,text,139,1049,58,16,18.png,1024,1448,197,1065
3356,text,223,1049,36,16,18.png,1024,1448,259,1065
3357,text,313,1049,34,16,18.png,1024,1448,347,1065
3358,text,401,1045,58,20,18.png,1024,1448,459,1065
3359,text,689,1045,66,16,18.png,1024,1448,755,1061
3360,text,858,1036,110,24,18.png,1024,1448,968,1060
3361,text,45,1087,32,20,18.png,1024,1448,77,1107
3362,text,123,1085,66,20,18.png,1024,1448,189,1105
3363,text,223,1085,36,20,18.png,1024,1448,259,1105
3364,text,295,1085,52,20,18.png,1024,1448,347,1105
3365,text,395,1085,64,20,18.png,1024,1448,459,1105
3366,text,695,1083,64,18,18.png,1024,1448,759,1101
3367,text,905,1079,64,20,18.png,1024,1448,969,1099
3368,text,42,1140,348,26,18.png,1024,1448,390,1166
3369,text,44,1190,122,26,18.png,1024,1448,166,1216
3370,text,234,1323,497,27,18.png,1024,1448,731,1350
3371,text,154,1346,36,24,18.png,1024,1448,190,1370
3372,text,199,1348,151,22,18.png,1024,1448,350,1370
3373,text,352,1349,160,21,18.png,1024,1448,512,1370
3374,text,519,1350,167,22,18.png,1024,1448,686,1372
3375,text,384,1370,132,24,18.png,1024,1448,516,1394
3376,text,522,1372,122,24,18.png,1024,1448,644,1396
3377,text,753,1378,199,22,18.png,1024,1448,952,1400
3378,text,695,1353,244,25,18.png,1024,1448,939,1378
3379,text,657,1376,90,24,18.png,1024,1448,747,1400
3380,text,76,1363,181,29,18.png,1024,1448,257,1392
3381,text,257,1368,120,22,18.png,1024,1448,377,1390
3382,text,418,39,398,48,18_contrasted.png,1024,1448,816,87
3383,text,295,104,248,50,18_contrasted.png,1024,1448,543,154
3384,text,565,102,204,48,18_contrasted.png,1024,1448,769,150
3385,text,795,101,172,42,18_contrasted.png,1024,1448,967,143
3386,text,587,149,92,38,18_contrasted.png,1024,1448,679,187
3387,text,43,245,56,16,18_contrasted.png,1024,1448,99,261
3388,text,177,243,34,16,18_contrasted.png,1024,1448,211,259
3389,text,556,242,212,24,18_contrasted.png,1024,1448,768,266
3390,text,40,280,74,24,18_contrasted.png,1024,1448,114,304
3391,text,172,278,82,24,18_contrasted.png,1024,1448,254,302
3392,text,47,327,72,16,18_contrasted.png,1024,1448,119,343
3393,text,555,323,42,20,18_contrasted.png,1024,1448,597,343
3394,text,556,340,160,24,18_contrasted.png,1024,1448,716,364
3395,text,30,418,152,48,18_contrasted.png,1024,1448,182,466
3396,text,617,523,26,16,18_contrasted.png,1024,1448,643,539
3397,text,733,521,72,16,18_contrasted.png,1024,1448,805,537
3398,text,881,517,86,20,18_contrasted.png,1024,1448,967,537
3399,text,46,526,85,20,18_contrasted.png,1024,1448,131,546
3400,text,44,552,126,24,18_contrasted.png,1024,1448,170,576
3401,text,609,549,36,20,18_contrasted.png,1024,1448,645,569
3402,text,753,549,52,18,18_contrasted.png,1024,1448,805,567
3403,text,907,547,54,20,18_contrasted.png,1024,1448,961,567
3404,text,44,574,126,24,18_contrasted.png,1024,1448,170,598
3405,text,611,571,34,20,18_contrasted.png,1024,1448,645,591
3406,text,753,569,52,20,18_contrasted.png,1024,1448,805,589
3407,text,909,569,52,20,18_contrasted.png,1024,1448,961,589
3408,text,45,597,104,20,18_contrasted.png,1024,1448,149,617
3409,text,609,593,36,20,18_contrasted.png,1024,1448,645,613
3410,text,753,591,52,20,18_contrasted.png,1024,1448,805,611
3411,text,909,591,52,20,18_contrasted.png,1024,1448,961,611
3412,text,45,619,126,20,18_contrasted.png,1024,1448,171,639
3413,text,609,615,36,20,18_contrasted.png,1024,1448,645,635
3414,text,751,613,54,20,18_contrasted.png,1024,1448,805,633
3415,text,907,613,54,20,18_contrasted.png,1024,1448,961,633
3416,text,45,641,122,20,18_contrasted.png,1024,1448,167,661
3417,text,609,637,36,20,18_contrasted.png,1024,1448,645,657
3418,text,751,635,54,20,18_contrasted.png,1024,1448,805,655
3419,text,909,633,52,20,18_contrasted.png,1024,1448,961,653
3420,text,44,660,156,24,18_contrasted.png,1024,1448,200,684
3421,text,611,661,34,16,18_contrasted.png,1024,1448,645,677
3422,text,751,657,54,20,18_contrasted.png,1024,1448,805,677
3423,text,907,655,54,20,18_contrasted.png,1024,1448,961,675
3424,text,45,685,92,20,18_contrasted.png,1024,1448,137,705
3425,text,609,679,36,20,18_contrasted.png,1024,1448,645,699
3426,text,751,677,54,20,18_contrasted.png,1024,1448,805,697
3427,text,907,677,54,20,18_contrasted.png,1024,1448,961,697
3428,text,44,704,171,21,18_contrasted.png,1024,1448,215,725
3429,text,609,701,36,20,18_contrasted.png,1024,1448,645,721
3430,text,751,699,54,20,18_contrasted.png,1024,1448,805,719
3431,text,907,699,54,18,18_contrasted.png,1024,1448,961,717
3432,text,44,723,129,25,18_contrasted.png,1024,1448,173,748
3433,text,611,725,34,18,18_contrasted.png,1024,1448,645,743
3434,text,751,721,54,20,18_contrasted.png,1024,1448,805,741
3435,text,907,719,54,20,18_contrasted.png,1024,1448,961,739
3436,text,45,1053,38,14,18_contrasted.png,1024,1448,83,1067
3437,text,139,1049,58,16,18_contrasted.png,1024,1448,197,1065
3438,text,223,1049,36,16,18_contrasted.png,1024,1448,259,1065
3439,text,313,1049,34,16,18_contrasted.png,1024,1448,347,1065
3440,text,401,1045,58,20,18_contrasted.png,1024,1448,459,1065
3441,text,689,1045,66,16,18_contrasted.png,1024,1448,755,1061
3442,text,858,1036,110,24,18_contrasted.png,1024,1448,968,1060
3443,text,45,1087,32,20,18_contrasted.png,1024,1448,77,1107
3444,text,123,1085,66,20,18_contrasted.png,1024,1448,189,1105
3445,text,223,1085,36,20,18_contrasted.png,1024,1448,259,1105
3446,text,295,1085,52,20,18_contrasted.png,1024,1448,347,1105
3447,text,395,1085,64,20,18_contrasted.png,1024,1448,459,1105
3448,text,695,1083,64,18,18_contrasted.png,1024,1448,759,1101
3449,text,905,1079,64,20,18_contrasted.png,1024,1448,969,1099
3450,text,42,1140,348,26,18_contrasted.png,1024,1448,390,1166
3451,text,44,1190,122,26,18_contrasted.png,1024,1448,166,1216
3452,text,234,1323,497,27,18_contrasted.png,1024,1448,731,1350
3453,text,154,1346,36,24,18_contrasted.png,1024,1448,190,1370
3454,text,199,1348,151,22,18_contrasted.png,1024,1448,350,1370
3455,text,352,1349,160,21,18_contrasted.png,1024,1448,512,1370
3456,text,519,1350,167,22,18_contrasted.png,1024,1448,686,1372
3457,text,384,1370,132,24,18_contrasted.png,1024,1448,516,1394
3458,text,522,1372,122,24,18_contrasted.png,1024,1448,644,1396
3459,text,753,1378,199,22,18_contrasted.png,1024,1448,952,1400
3460,text,695,1353,244,25,18_contrasted.png,1024,1448,939,1378
3461,text,657,1376,90,24,18_contrasted.png,1024,1448,747,1400
3462,text,76,1363,181,29,18_contrasted.png,1024,1448,257,1392
3463,text,257,1368,120,22,18_contrasted.png,1024,1448,377,1390
3464,text,418,39,398,48,18_denoise.png,1024,1448,816,87
3465,text,295,104,248,50,18_denoise.png,1024,1448,543,154
3466,text,565,102,204,48,18_denoise.png,1024,1448,769,150
3467,text,795,101,172,42,18_denoise.png,1024,1448,967,143
3468,text,587,149,92,38,18_denoise.png,1024,1448,679,187
3469,text,43,245,56,16,18_denoise.png,1024,1448,99,261
3470,text,177,243,34,16,18_denoise.png,1024,1448,211,259
3471,text,556,242,212,24,18_denoise.png,1024,1448,768,266
3472,text,40,280,74,24,18_denoise.png,1024,1448,114,304
3473,text,172,278,82,24,18_denoise.png,1024,1448,254,302
3474,text,47,327,72,16,18_denoise.png,1024,1448,119,343
3475,text,555,323,42,20,18_denoise.png,1024,1448,597,343
3476,text,556,340,160,24,18_denoise.png,1024,1448,716,364
3477,text,30,418,152,48,18_denoise.png,1024,1448,182,466
3478,text,617,523,26,16,18_denoise.png,1024,1448,643,539
3479,text,733,521,72,16,18_denoise.png,1024,1448,805,537
3480,text,881,517,86,20,18_denoise.png,1024,1448,967,537
3481,text,46,526,85,20,18_denoise.png,1024,1448,131,546
3482,text,44,552,126,24,18_denoise.png,1024,1448,170,576
3483,text,609,549,36,20,18_denoise.png,1024,1448,645,569
3484,text,753,549,52,18,18_denoise.png,1024,1448,805,567
3485,text,907,547,54,20,18_denoise.png,1024,1448,961,567
3486,text,44,574,126,24,18_denoise.png,1024,1448,170,598
3487,text,611,571,34,20,18_denoise.png,1024,1448,645,591
3488,text,753,569,52,20,18_denoise.png,1024,1448,805,589
3489,text,909,569,52,20,18_denoise.png,1024,1448,961,589
3490,text,45,597,104,20,18_denoise.png,1024,1448,149,617
3491,text,609,593,36,20,18_denoise.png,1024,1448,645,613
3492,text,753,591,52,20,18_denoise.png,1024,1448,805,611
3493,text,909,591,52,20,18_denoise.png,1024,1448,961,611
3494,text,45,619,126,20,18_denoise.png,1024,1448,171,639
3495,text,609,615,36,20,18_denoise.png,1024,1448,645,635
3496,text,751,613,54,20,18_denoise.png,1024,1448,805,633
3497,text,907,613,54,20,18_denoise.png,1024,1448,961,633
3498,text,45,641,122,20,18_denoise.png,1024,1448,167,661
3499,text,609,637,36,20,18_denoise.png,1024,1448,645,657
3500,text,751,635,54,20,18_denoise.png,1024,1448,805,655
3501,text,909,633,52,20,18_denoise.png,1024,1448,961,653
3502,text,44,660,156,24,18_denoise.png,1024,1448,200,684
3503,text,611,661,34,16,18_denoise.png,1024,1448,645,677
3504,text,751,657,54,20,18_denoise.png,1024,1448,805,677
3505,text,907,655,54,20,18_denoise.png,1024,1448,961,675
3506,text,45,685,92,20,18_denoise.png,1024,1448,137,705
3507,text,609,679,36,20,18_denoise.png,1024,1448,645,699
3508,text,751,677,54,20,18_denoise.png,1024,1448,805,697
3509,text,907,677,54,20,18_denoise.png,1024,1448,961,697
3510,text,44,704,171,21,18_denoise.png,1024,1448,215,725
3511,text,609,701,36,20,18_denoise.png,1024,1448,645,721
3512,text,751,699,54,20,18_denoise.png,1024,1448,805,719
3513,text,907,699,54,18,18_denoise.png,1024,1448,961,717
3514,text,44,723,129,25,18_denoise.png,1024,1448,173,748
3515,text,611,725,34,18,18_denoise.png,1024,1448,645,743
3516,text,751,721,54,20,18_denoise.png,1024,1448,805,741
3517,text,907,719,54,20,18_denoise.png,1024,1448,961,739
3518,text,45,1053,38,14,18_denoise.png,1024,1448,83,1067
3519,text,139,1049,58,16,18_denoise.png,1024,1448,197,1065
3520,text,223,1049,36,16,18_denoise.png,1024,1448,259,1065
3521,text,313,1049,34,16,18_denoise.png,1024,1448,347,1065
3522,text,401,1045,58,20,18_denoise.png,1024,1448,459,1065
3523,text,689,1045,66,16,18_denoise.png,1024,1448,755,1061
3524,text,858,1036,110,24,18_denoise.png,1024,1448,968,1060
3525,text,45,1087,32,20,18_denoise.png,1024,1448,77,1107
3526,text,123,1085,66,20,18_denoise.png,1024,1448,189,1105
3527,text,223,1085,36,20,18_denoise.png,1024,1448,259,1105
3528,text,295,1085,52,20,18_denoise.png,1024,1448,347,1105
3529,text,395,1085,64,20,18_denoise.png,1024,1448,459,1105
3530,text,695,1083,64,18,18_denoise.png,1024,1448,759,1101
3531,text,905,1079,64,20,18_denoise.png,1024,1448,969,1099
3532,text,42,1140,348,26,18_denoise.png,1024,1448,390,1166
3533,text,44,1190,122,26,18_denoise.png,1024,1448,166,1216
3534,text,234,1323,497,27,18_denoise.png,1024,1448,731,1350
3535,text,154,1346,36,24,18_denoise.png,1024,1448,190,1370
3536,text,199,1348,151,22,18_denoise.png,1024,1448,350,1370
3537,text,352,1349,160,21,18_denoise.png,1024,1448,512,1370
3538,text,519,1350,167,22,18_denoise.png,1024,1448,686,1372
3539,text,384,1370,132,24,18_denoise.png,1024,1448,516,1394
3540,text,522,1372,122,24,18_denoise.png,1024,1448,644,1396
3541,text,753,1378,199,22,18_denoise.png,1024,1448,952,1400
3542,text,695,1353,244,25,18_denoise.png,1024,1448,939,1378
3543,text,657,1376,90,24,18_denoise.png,1024,1448,747,1400
3544,text,76,1363,181,29,18_denoise.png,1024,1448,257,1392
3545,text,257,1368,120,22,18_denoise.png,1024,1448,377,1390
3546,text,418,39,398,48,18_median.png,1024,1448,816,87
3547,text,295,104,248,50,18_median.png,1024,1448,543,154
3548,text,565,102,204,48,18_median.png,1024,1448,769,150
3549,text,795,101,172,42,18_median.png,1024,1448,967,143
3550,text,587,149,92,38,18_median.png,1024,1448,679,187
3551,text,43,245,56,16,18_median.png,1024,1448,99,261
3552,text,177,243,34,16,18_median.png,1024,1448,211,259
3553,text,556,242,212,24,18_median.png,1024,1448,768,266
3554,text,40,280,74,24,18_median.png,1024,1448,114,304
3555,text,172,278,82,24,18_median.png,1024,1448,254,302
3556,text,47,327,72,16,18_median.png,1024,1448,119,343
3557,text,555,323,42,20,18_median.png,1024,1448,597,343
3558,text,556,340,160,24,18_median.png,1024,1448,716,364
3559,text,30,418,152,48,18_median.png,1024,1448,182,466
3560,text,617,523,26,16,18_median.png,1024,1448,643,539
3561,text,733,521,72,16,18_median.png,1024,1448,805,537
3562,text,881,517,86,20,18_median.png,1024,1448,967,537
3563,text,46,526,85,20,18_median.png,1024,1448,131,546
3564,text,44,552,126,24,18_median.png,1024,1448,170,576
3565,text,609,549,36,20,18_median.png,1024,1448,645,569
3566,text,753,549,52,18,18_median.png,1024,1448,805,567
3567,text,907,547,54,20,18_median.png,1024,1448,961,567
3568,text,44,574,126,24,18_median.png,1024,1448,170,598
3569,text,611,571,34,20,18_median.png,1024,1448,645,591
3570,text,753,569,52,20,18_median.png,1024,1448,805,589
3571,text,909,569,52,20,18_median.png,1024,1448,961,589
3572,text,45,597,104,20,18_median.png,1024,1448,149,617
3573,text,609,593,36,20,18_median.png,1024,1448,645,613
3574,text,753,591,52,20,18_median.png,1024,1448,805,611
3575,text,909,591,52,20,18_median.png,1024,1448,961,611
3576,text,45,619,126,20,18_median.png,1024,1448,171,639
3577,text,609,615,36,20,18_median.png,1024,1448,645,635
3578,text,751,613,54,20,18_median.png,1024,1448,805,633
3579,text,907,613,54,20,18_median.png,1024,1448,961,633
3580,text,45,641,122,20,18_median.png,1024,1448,167,661
3581,text,609,637,36,20,18_median.png,1024,1448,645,657
3582,text,751,635,54,20,18_median.png,1024,1448,805,655
3583,text,909,633,52,20,18_median.png,1024,1448,961,653
3584,text,44,660,156,24,18_median.png,1024,1448,200,684
3585,text,611,661,34,16,18_median.png,1024,1448,645,677
3586,text,751,657,54,20,18_median.png,1024,1448,805,677
3587,text,907,655,54,20,18_median.png,1024,1448,961,675
3588,text,45,685,92,20,18_median.png,1024,1448,137,705
3589,text,609,679,36,20,18_median.png,1024,1448,645,699
3590,text,751,677,54,20,18_median.png,1024,1448,805,697
3591,text,907,677,54,20,18_median.png,1024,1448,961,697
3592,text,44,704,171,21,18_median.png,1024,1448,215,725
3593,text,609,701,36,20,18_median.png,1024,1448,645,721
3594,text,751,699,54,20,18_median.png,1024,1448,805,719
3595,text,907,699,54,18,18_median.png,1024,1448,961,717
3596,text,44,723,129,25,18_median.png,1024,1448,173,748
3597,text,611,725,34,18,18_median.png,1024,1448,645,743
3598,text,751,721,54,20,18_median.png,1024,1448,805,741
3599,text,907,719,54,20,18_median.png,1024,1448,961,739
3600,text,45,1053,38,14,18_median.png,1024,1448,83,1067
3601,text,139,1049,58,16,18_median.png,1024,1448,197,1065
3602,text,223,1049,36,16,18_median.png,1024,1448,259,1065
3603,text,313,1049,34,16,18_median.png,1024,1448,347,1065
3604,text,401,1045,58,20,18_median.png,1024,1448,459,1065
3605,text,689,1045,66,16,18_median.png,1024,1448,755,1061
3606,text,858,1036,110,24,18_median.png,1024,1448,968,1060
3607,text,45,1087,32,20,18_median.png,1024,1448,77,1107
3608,text,123,1085,66,20,18_median.png,1024,1448,189,1105
3609,text,223,1085,36,20,18_median.png,1024,1448,259,1105
3610,text,295,1085,52,20,18_median.png,1024,1448,347,1105
3611,text,395,1085,64,20,18_median.png,1024,1448,459,1105
3612,text,695,1083,64,18,18_median.png,1024,1448,759,1101
3613,text,905,1079,64,20,18_median.png,1024,1448,969,1099
3614,text,42,1140,348,26,18_median.png,1024,1448,390,1166
3615,text,44,1190,122,26,18_median.png,1024,1448,166,1216
3616,text,234,1323,497,27,18_median.png,1024,1448,731,1350
3617,text,154,1346,36,24,18_median.png,1024,1448,190,1370
3618,text,199,1348,151,22,18_median.png,1024,1448,350,1370
3619,text,352,1349,160,21,18_median.png,1024,1448,512,1370
3620,text,519,1350,167,22,18_median.png,1024,1448,686,1372
3621,text,384,1370,132,24,18_median.png,1024,1448,516,1394
3622,text,522,1372,122,24,18_median.png,1024,1448,644,1396
3623,text,753,1378,199,22,18_median.png,1024,1448,952,1400
3624,text,695,1353,244,25,18_median.png,1024,1448,939,1378
3625,text,657,1376,90,24,18_median.png,1024,1448,747,1400
3626,text,76,1363,181,29,18_median.png,1024,1448,257,1392
3627,text,257,1368,120,22,18_median.png,1024,1448,377,1390
3628,text,359,61,311,61,19.png,1024,1448,670,122
3629,text,379,193,198,20,19.png,1024,1448,577,213
3630,text,127,343,140,42,19.png,1024,1448,267,385
3631,text,279,345,524,42,19.png,1024,1448,803,387
3632,text,376,394,196,24,19.png,1024,1448,572,418
3633,text,368,422,214,24,19.png,1024,1448,582,446
3634,text,203,471,105,28,19.png,1024,1448,308,499
3635,text,567,475,34,20,19.png,1024,1448,601,495
3636,text,653,475,78,20,19.png,1024,1448,731,495
3637,text,757,475,88,20,19.png,1024,1448,845,495
3638,text,122,573,260,27,19.png,1024,1448,382,600
3639,text,654,578,74,24,19.png,1024,1448,728,602
3640,text,762,578,74,24,19.png,1024,1448,836,602
3641,text,361,711,110,20,19.png,1024,1448,471,731
3642,text,760,710,74,24,19.png,1024,1448,834,734
3643,text,370,734,94,24,19.png,1024,1448,464,758
3644,text,766,736,62,24,19.png,1024,1448,828,760
3645,text,354,760,124,24,19.png,1024,1448,478,784
3646,text,760,762,74,24,19.png,1024,1448,834,786
3647,text,88,836,434,24,19.png,1024,1448,522,860
3648,text,87,863,76,20,19.png,1024,1448,163,883
3649,text,173,863,114,20,19.png,1024,1448,287,883
3650,text,296,862,174,24,19.png,1024,1448,470,886
3651,text,482,862,122,24,19.png,1024,1448,604,886
3652,text,142,1309,256,25,19.png,1024,1448,398,1334
3653,text,443,1335,104,20,19.png,1024,1448,547,1355
3654,text,580,1356,168,24,19.png,1024,1448,748,1380
3655,text,571,573,21,30,19.png,1024,1448,592,603
3656,text,459,575,27,26,19.png,1024,1448,486,601
3657,text,464,473,24,23,19.png,1024,1448,488,496
3658,text,402,1309,157,26,19.png,1024,1448,559,1335
3659,text,562,1310,288,23,19.png,1024,1448,850,1333
3660,text,501,1356,74,23,19.png,1024,1448,575,1379
3661,text,402,1358,95,21,19.png,1024,1448,497,1379
3662,text,241,1355,84,25,19.png,1024,1448,325,1380
3663,text,330,1356,68,23,19.png,1024,1448,398,1379
3664,text,359,61,311,61,19_contrasted.png,1024,1448,670,122
3665,text,379,193,198,20,19_contrasted.png,1024,1448,577,213
3666,text,127,343,140,42,19_contrasted.png,1024,1448,267,385
3667,text,279,345,524,42,19_contrasted.png,1024,1448,803,387
3668,text,376,394,196,24,19_contrasted.png,1024,1448,572,418
3669,text,368,422,214,24,19_contrasted.png,1024,1448,582,446
3670,text,203,471,105,28,19_contrasted.png,1024,1448,308,499
3671,text,567,475,34,20,19_contrasted.png,1024,1448,601,495
3672,text,653,475,78,20,19_contrasted.png,1024,1448,731,495
3673,text,757,475,88,20,19_contrasted.png,1024,1448,845,495
3674,text,122,573,260,27,19_contrasted.png,1024,1448,382,600
3675,text,654,578,74,24,19_contrasted.png,1024,1448,728,602
3676,text,762,578,74,24,19_contrasted.png,1024,1448,836,602
3677,text,361,711,110,20,19_contrasted.png,1024,1448,471,731
3678,text,760,710,74,24,19_contrasted.png,1024,1448,834,734
3679,text,370,734,94,24,19_contrasted.png,1024,1448,464,758
3680,text,766,736,62,24,19_contrasted.png,1024,1448,828,760
3681,text,354,760,124,24,19_contrasted.png,1024,1448,478,784
3682,text,760,762,74,24,19_contrasted.png,1024,1448,834,786
3683,text,88,836,434,24,19_contrasted.png,1024,1448,522,860
3684,text,87,863,76,20,19_contrasted.png,1024,1448,163,883
3685,text,173,863,114,20,19_contrasted.png,1024,1448,287,883
3686,text,296,862,174,24,19_contrasted.png,1024,1448,470,886
3687,text,482,862,122,24,19_contrasted.png,1024,1448,604,886
3688,text,142,1309,256,25,19_contrasted.png,1024,1448,398,1334
3689,text,443,1335,104,20,19_contrasted.png,1024,1448,547,1355
3690,text,580,1356,168,24,19_contrasted.png,1024,1448,748,1380
3691,text,571,573,21,30,19_contrasted.png,1024,1448,592,603
3692,text,459,575,27,26,19_contrasted.png,1024,1448,486,601
3693,text,464,473,24,23,19_contrasted.png,1024,1448,488,496
3694,text,402,1309,157,26,19_contrasted.png,1024,1448,559,1335
3695,text,562,1310,288,23,19_contrasted.png,1024,1448,850,1333
3696,text,501,1356,74,23,19_contrasted.png,1024,1448,575,1379
3697,text,402,1358,95,21,19_contrasted.png,1024,1448,497,1379
3698,text,241,1355,84,25,19_contrasted.png,1024,1448,325,1380
3699,text,330,1356,68,23,19_contrasted.png,1024,1448,398,1379
3700,text,359,61,311,61,19_denoise.png,1024,1448,670,122
3701,text,379,193,198,20,19_denoise.png,1024,1448,577,213
3702,text,127,343,140,42,19_denoise.png,1024,1448,267,385
3703,text,279,345,524,42,19_denoise.png,1024,1448,803,387
3704,text,376,394,196,24,19_denoise.png,1024,1448,572,418
3705,text,368,422,214,24,19_denoise.png,1024,1448,582,446
3706,text,203,471,105,28,19_denoise.png,1024,1448,308,499
3707,text,567,475,34,20,19_denoise.png,1024,1448,601,495
3708,text,653,475,78,20,19_denoise.png,1024,1448,731,495
3709,text,757,475,88,20,19_denoise.png,1024,1448,845,495
3710,text,122,573,260,27,19_denoise.png,1024,1448,382,600
3711,text,654,578,74,24,19_denoise.png,1024,1448,728,602
3712,text,762,578,74,24,19_denoise.png,1024,1448,836,602
3713,text,361,711,110,20,19_denoise.png,1024,1448,471,731
3714,text,760,710,74,24,19_denoise.png,1024,1448,834,734
3715,text,370,734,94,24,19_denoise.png,1024,1448,464,758
3716,text,766,736,62,24,19_denoise.png,1024,1448,828,760
3717,text,354,760,124,24,19_denoise.png,1024,1448,478,784
3718,text,760,762,74,24,19_denoise.png,1024,1448,834,786
3719,text,88,836,434,24,19_denoise.png,1024,1448,522,860
3720,text,87,863,76,20,19_denoise.png,1024,1448,163,883
3721,text,173,863,114,20,19_denoise.png,1024,1448,287,883
3722,text,296,862,174,24,19_denoise.png,1024,1448,470,886
3723,text,482,862,122,24,19_denoise.png,1024,1448,604,886
3724,text,142,1309,256,25,19_denoise.png,1024,1448,398,1334
3725,text,443,1335,104,20,19_denoise.png,1024,1448,547,1355
3726,text,580,1356,168,24,19_denoise.png,1024,1448,748,1380
3727,text,571,573,21,30,19_denoise.png,1024,1448,592,603
3728,text,459,575,27,26,19_denoise.png,1024,1448,486,601
3729,text,464,473,24,23,19_denoise.png,1024,1448,488,496
3730,text,402,1309,157,26,19_denoise.png,1024,1448,559,1335
3731,text,562,1310,288,23,19_denoise.png,1024,1448,850,1333
3732,text,501,1356,74,23,19_denoise.png,1024,1448,575,1379
3733,text,402,1358,95,21,19_denoise.png,1024,1448,497,1379
3734,text,241,1355,84,25,19_denoise.png,1024,1448,325,1380
3735,text,330,1356,68,23,19_denoise.png,1024,1448,398,1379
3736,text,359,61,311,61,19_median.png,1024,1448,670,122
3737,text,379,193,198,20,19_median.png,1024,1448,577,213
3738,text,127,343,140,42,19_median.png,1024,1448,267,385
3739,text,279,345,524,42,19_median.png,1024,1448,803,387
3740,text,376,394,196,24,19_median.png,1024,1448,572,418
3741,text,368,422,214,24,19_median.png,1024,1448,582,446
3742,text,203,471,105,28,19_median.png,1024,1448,308,499
3743,text,567,475,34,20,19_median.png,1024,1448,601,495
3744,text,653,475,78,20,19_median.png,1024,1448,731,495
3745,text,757,475,88,20,19_median.png,1024,1448,845,495
3746,text,122,573,260,27,19_median.png,1024,1448,382,600
3747,text,654,578,74,24,19_median.png,1024,1448,728,602
3748,text,762,578,74,24,19_median.png,1024,1448,836,602
3749,text,361,711,110,20,19_median.png,1024,1448,471,731
3750,text,760,710,74,24,19_median.png,1024,1448,834,734
3751,text,370,734,94,24,19_median.png,1024,1448,464,758
3752,text,766,736,62,24,19_median.png,1024,1448,828,760
3753,text,354,760,124,24,19_median.png,1024,1448,478,784
3754,text,760,762,74,24,19_median.png,1024,1448,834,786
3755,text,88,836,434,24,19_median.png,1024,1448,522,860
3756,text,87,863,76,20,19_median.png,1024,1448,163,883
3757,text,173,863,114,20,19_median.png,1024,1448,287,883
3758,text,296,862,174,24,19_median.png,1024,1448,470,886
3759,text,482,862,122,24,19_median.png,1024,1448,604,886
3760,text,142,1309,256,25,19_median.png,1024,1448,398,1334
3761,text,443,1335,104,20,19_median.png,1024,1448,547,1355
3762,text,580,1356,168,24,19_median.png,1024,1448,748,1380
3763,text,571,573,21,30,19_median.png,1024,1448,592,603
3764,text,459,575,27,26,19_median.png,1024,1448,486,601
3765,text,464,473,24,23,19_median.png,1024,1448,488,496
3766,text,402,1309,157,26,19_median.png,1024,1448,559,1335
3767,text,562,1310,288,23,19_median.png,1024,1448,850,1333
3768,text,501,1356,74,23,19_median.png,1024,1448,575,1379
3769,text,402,1358,95,21,19_median.png,1024,1448,497,1379
3770,text,241,1355,84,25,19_median.png,1024,1448,325,1380
3771,text,330,1356,68,23,19_median.png,1024,1448,398,1379
3772,text,374,76,362,32,1_contrasted.png,1024,1448,736,108
3773,text,442,112,229,30,1_contrasted.png,1024,1448,671,142
3774,text,386,144,90,26,1_contrasted.png,1024,1448,476,170
3775,text,492,144,231,26,1_contrasted.png,1024,1448,723,170
3776,text,138,204,80,28,1_contrasted.png,1024,1448,218,232
3777,text,239,200,318,37,1_contrasted.png,1024,1448,557,237
3778,text,676,213,168,27,1_contrasted.png,1024,1448,844,240
3779,text,136,260,230,24,1_contrasted.png,1024,1448,366,284
3780,text,678,296,252,26,1_contrasted.png,1024,1448,930,322
3781,text,138,312,106,26,1_contrasted.png,1024,1448,244,338
3782,text,135,338,357,28,1_contrasted.png,1024,1448,492,366
3783,text,137,362,65,27,1_contrasted.png,1024,1448,202,389
3784,text,180,438,216,26,1_contrasted.png,1024,1448,396,464
3785,text,412,438,424,28,1_contrasted.png,1024,1448,836,466
3786,text,180,526,230,28,1_contrasted.png,1024,1448,410,554
3787,text,856,528,112,26,1_contrasted.png,1024,1448,968,554
3788,text,180,556,164,30,1_contrasted.png,1024,1448,344,586
3789,text,870,556,96,26,1_contrasted.png,1024,1448,966,582
3790,text,178,584,162,26,1_contrasted.png,1024,1448,340,610
3791,text,856,584,110,28,1_contrasted.png,1024,1448,966,612
3792,text,126,660,780,32,1_contrasted.png,1024,1448,906,692
3793,text,124,694,230,30,1_contrasted.png,1024,1448,354,724
3794,text,178,1209,664,27,1_contrasted.png,1024,1448,842,1236
3795,text,228,1237,226,23,1_contrasted.png,1024,1448,454,1260
3796,text,468,1238,319,25,1_contrasted.png,1024,1448,787,1263
3797,text,104,1265,202,22,1_contrasted.png,1024,1448,306,1287
3798,text,738,1263,176,24,1_contrasted.png,1024,1448,914,1287
3799,text,198,1288,614,28,1_contrasted.png,1024,1448,812,1316
3800,text,294,1320,426,22,1_contrasted.png,1024,1448,720,1342
3801,text,313,1263,253,24,1_contrasted.png,1024,1448,566,1287
3802,text,575,1263,148,24,1_contrasted.png,1024,1448,723,1287
3803,text,374,76,362,32,1_denoise.png,1024,1448,736,108
3804,text,442,112,229,30,1_denoise.png,1024,1448,671,142
3805,text,386,144,90,26,1_denoise.png,1024,1448,476,170
3806,text,492,144,231,26,1_denoise.png,1024,1448,723,170
3807,text,138,204,80,28,1_denoise.png,1024,1448,218,232
3808,text,239,200,318,37,1_denoise.png,1024,1448,557,237
3809,text,676,213,168,27,1_denoise.png,1024,1448,844,240
3810,text,136,260,230,24,1_denoise.png,1024,1448,366,284
3811,text,678,296,252,26,1_denoise.png,1024,1448,930,322
3812,text,138,312,106,26,1_denoise.png,1024,1448,244,338
3813,text,135,338,357,28,1_denoise.png,1024,1448,492,366
3814,text,137,362,65,27,1_denoise.png,1024,1448,202,389
3815,text,180,438,216,26,1_denoise.png,1024,1448,396,464
3816,text,412,438,424,28,1_denoise.png,1024,1448,836,466
3817,text,180,526,230,28,1_denoise.png,1024,1448,410,554
3818,text,856,528,112,26,1_denoise.png,1024,1448,968,554
3819,text,180,556,164,30,1_denoise.png,1024,1448,344,586
3820,text,870,556,96,26,1_denoise.png,1024,1448,966,582
3821,text,178,584,162,26,1_denoise.png,1024,1448,340,610
3822,text,856,584,110,28,1_denoise.png,1024,1448,966,612
3823,text,126,660,780,32,1_denoise.png,1024,1448,906,692
3824,text,124,694,230,30,1_denoise.png,1024,1448,354,724
3825,text,178,1209,664,27,1_denoise.png,1024,1448,842,1236
3826,text,228,1237,226,23,1_denoise.png,1024,1448,454,1260
3827,text,468,1238,319,25,1_denoise.png,1024,1448,787,1263
3828,text,104,1265,202,22,1_denoise.png,1024,1448,306,1287
3829,text,738,1263,176,24,1_denoise.png,1024,1448,914,1287
3830,text,198,1288,614,28,1_denoise.png,1024,1448,812,1316
3831,text,294,1320,426,22,1_denoise.png,1024,1448,720,1342
3832,text,313,1263,253,24,1_denoise.png,1024,1448,566,1287
3833,text,575,1263,148,24,1_denoise.png,1024,1448,723,1287
3834,text,374,76,362,32,1_median.png,1024,1448,736,108
3835,text,442,112,229,30,1_median.png,1024,1448,671,142
3836,text,386,144,90,26,1_median.png,1024,1448,476,170
3837,text,492,144,231,26,1_median.png,1024,1448,723,170
3838,text,138,204,80,28,1_median.png,1024,1448,218,232
3839,text,239,200,318,37,1_median.png,1024,1448,557,237
3840,text,676,213,168,27,1_median.png,1024,1448,844,240
3841,text,136,260,230,24,1_median.png,1024,1448,366,284
3842,text,678,296,252,26,1_median.png,1024,1448,930,322
3843,text,138,312,106,26,1_median.png,1024,1448,244,338
3844,text,135,338,357,28,1_median.png,1024,1448,492,366
3845,text,137,362,65,27,1_median.png,1024,1448,202,389
3846,text,180,438,216,26,1_median.png,1024,1448,396,464
3847,text,412,438,424,28,1_median.png,1024,1448,836,466
3848,text,180,526,230,28,1_median.png,1024,1448,410,554
3849,text,856,528,112,26,1_median.png,1024,1448,968,554
3850,text,180,556,164,30,1_median.png,1024,1448,344,586
3851,text,870,556,96,26,1_median.png,1024,1448,966,582
3852,text,178,584,162,26,1_median.png,1024,1448,340,610
3853,text,856,584,110,28,1_median.png,1024,1448,966,612
3854,text,126,660,780,32,1_median.png,1024,1448,906,692
3855,text,124,694,230,30,1_median.png,1024,1448,354,724
3856,text,178,1209,664,27,1_median.png,1024,1448,842,1236
3857,text,228,1237,226,23,1_median.png,1024,1448,454,1260
3858,text,468,1238,319,25,1_median.png,1024,1448,787,1263
3859,text,104,1265,202,22,1_median.png,1024,1448,306,1287
3860,text,738,1263,176,24,1_median.png,1024,1448,914,1287
3861,text,198,1288,614,28,1_median.png,1024,1448,812,1316
3862,text,294,1320,426,22,1_median.png,1024,1448,720,1342
3863,text,313,1263,253,24,1_median.png,1024,1448,566,1287
3864,text,575,1263,148,24,1_median.png,1024,1448,723,1287
3865,text,598,41,354,28,2.png,1024,1448,952,69
3866,text,598,102,122,26,2.png,1024,1448,720,128
3867,text,600,72,194,26,2.png,1024,1448,794,98
3868,text,717,99,149,32,2.png,1024,1448,866,131
3869,text,597,125,387,37,2.png,1024,1448,984,162
3870,text,64,142,156,42,2.png,1024,1448,220,184
3871,text,69,179,150,28,2.png,1024,1448,219,207
3872,text,534,210,84,24,2.png,1024,1448,618,234
3873,text,531,275,164,20,2.png,1024,1448,695,295
3874,text,55,283,157,49,2.png,1024,1448,212,332
3875,text,85,365,66,18,2.png,1024,1448,151,383
3876,text,201,367,80,18,2.png,1024,1448,281,385
3877,text,307,367,98,20,2.png,1024,1448,405,387
3878,text,435,369,46,16,2.png,1024,1448,481,385
3879,text,547,371,38,16,2.png,1024,1448,585,387
3880,text,625,369,158,20,2.png,1024,1448,783,389
3881,text,829,371,88,18,2.png,1024,1448,917,389
3882,text,81,394,79,26,2.png,1024,1448,160,420
3883,text,209,399,64,20,2.png,1024,1448,273,419
3884,text,331,401,44,18,2.png,1024,1448,375,419
3885,text,69,464,81,27,2.png,1024,1448,150,491
3886,text,322,470,94,24,2.png,1024,1448,416,494
3887,text,603,473,30,20,2.png,1024,1448,633,493
3888,text,691,473,56,20,2.png,1024,1448,747,493
3889,text,769,477,58,18,2.png,1024,1448,827,495
3890,text,849,475,86,20,2.png,1024,1448,935,495
3891,text,70,500,64,24,2.png,1024,1448,134,524
3892,text,182,502,302,24,2.png,1024,1448,484,526
3893,text,605,507,36,20,2.png,1024,1448,641,527
3894,text,719,509,44,20,2.png,1024,1448,763,529
3895,text,891,509,52,20,2.png,1024,1448,943,529
3896,text,127,1063,112,16,2.png,1024,1448,239,1079
3897,text,375,1071,66,20,2.png,1024,1448,441,1091
3898,text,503,1071,34,20,2.png,1024,1448,537,1091
3899,text,581,1073,98,20,2.png,1024,1448,679,1093
3900,text,709,1073,74,20,2.png,1024,1448,783,1093
3901,text,815,1075,106,20,2.png,1024,1448,921,1095
3902,text,380,1102,54,24,2.png,1024,1448,434,1126
3903,text,493,1105,56,20,2.png,1024,1448,549,1125
3904,text,607,1107,44,20,2.png,1024,1448,651,1127
3905,text,715,1107,52,20,2.png,1024,1448,767,1127
3906,text,839,1109,54,20,2.png,1024,1448,893,1129
3907,text,48,1220,446,25,2.png,1024,1448,494,1245
3908,text,46,1244,348,24,2.png,1024,1448,394,1268
3909,text,75,1368,236,21,2.png,1024,1448,311,1389
3910,text,324,1368,64,22,2.png,1024,1448,388,1390
3911,text,667,1367,267,20,2.png,1024,1448,934,1387
3912,text,36,1388,170,24,2.png,1024,1448,206,1412
3913,text,214,1386,212,24,2.png,1024,1448,426,1410
3914,text,433,1389,146,20,2.png,1024,1448,579,1409
3915,text,809,1388,159,22,2.png,1024,1448,968,1410
3916,text,395,1367,124,21,2.png,1024,1448,519,1388
3917,text,529,1367,129,22,2.png,1024,1448,658,1389
3918,text,740,1390,62,19,2.png,1024,1448,802,1409
3919,text,664,1388,68,19,2.png,1024,1448,732,1407
3920,text,591,1389,60,21,2.png,1024,1448,651,1410
3921,text,190,40,482,76,20.png,1024,1448,672,116
3922,text,686,72,28,26,20.png,1024,1448,714,98
3923,text,722,42,134,74,20.png,1024,1448,856,116
3924,text,657,358,225,26,20.png,1024,1448,882,384
3925,text,125,431,139,40,20.png,1024,1448,264,471
3926,text,277,431,524,44,20.png,1024,1448,801,475
3927,text,374,482,196,24,20.png,1024,1448,570,506
3928,text,318,554,252,26,20.png,1024,1448,570,580
3929,text,163,602,121,29,20.png,1024,1448,284,631
3930,text,533,609,38,20,20.png,1024,1448,571,629
3931,text,616,606,90,24,20.png,1024,1448,706,630
3932,text,746,608,102,24,20.png,1024,1448,848,632
3933,text,80,680,282,26,20.png,1024,1448,362,706
3934,text,524,684,52,24,20.png,1024,1448,576,708
3935,text,636,686,46,24,20.png,1024,1448,682,710
3936,text,756,686,80,26,20.png,1024,1448,836,712
3937,text,328,812,116,26,20.png,1024,1448,444,838
3938,text,754,816,82,26,20.png,1024,1448,836,842
3939,text,338,840,94,24,20.png,1024,1448,432,864
3940,text,760,842,70,26,20.png,1024,1448,830,868
3941,text,322,864,126,26,20.png,1024,1448,448,890
3942,text,752,868,82,26,20.png,1024,1448,834,894
3943,text,62,938,460,24,20.png,1024,1448,522,962
3944,text,56,962,404,26,20.png,1024,1448,460,988
3945,text,277,1323,96,20,20.png,1024,1448,373,1343
3946,text,381,1323,349,20,20.png,1024,1448,730,1343
3947,text,273,1345,84,18,20.png,1024,1448,357,1363
3948,text,367,1345,100,18,20.png,1024,1448,467,1363
3949,text,475,1345,262,20,20.png,1024,1448,737,1365
3950,text,429,680,26,28,20.png,1024,1448,455,708
3951,text,432,606,22,22,20.png,1024,1448,454,628
3952,text,190,40,482,76,20_contrasted.png,1024,1448,672,116
3953,text,686,72,28,26,20_contrasted.png,1024,1448,714,98
3954,text,722,42,134,74,20_contrasted.png,1024,1448,856,116
3955,text,657,358,225,26,20_contrasted.png,1024,1448,882,384
3956,text,125,431,139,40,20_contrasted.png,1024,1448,264,471
3957,text,277,431,524,44,20_contrasted.png,1024,1448,801,475
3958,text,374,482,196,24,20_contrasted.png,1024,1448,570,506
3959,text,318,554,252,26,20_contrasted.png,1024,1448,570,580
3960,text,163,602,121,29,20_contrasted.png,1024,1448,284,631
3961,text,533,609,38,20,20_contrasted.png,1024,1448,571,629
3962,text,616,606,90,24,20_contrasted.png,1024,1448,706,630
3963,text,746,608,102,24,20_contrasted.png,1024,1448,848,632
3964,text,80,680,282,26,20_contrasted.png,1024,1448,362,706
3965,text,524,684,52,24,20_contrasted.png,1024,1448,576,708
3966,text,636,686,46,24,20_contrasted.png,1024,1448,682,710
3967,text,756,686,80,26,20_contrasted.png,1024,1448,836,712
3968,text,328,812,116,26,20_contrasted.png,1024,1448,444,838
3969,text,754,816,82,26,20_contrasted.png,1024,1448,836,842
3970,text,338,840,94,24,20_contrasted.png,1024,1448,432,864
3971,text,760,842,70,26,20_contrasted.png,1024,1448,830,868
3972,text,322,864,126,26,20_contrasted.png,1024,1448,448,890
3973,text,752,868,82,26,20_contrasted.png,1024,1448,834,894
3974,text,62,938,460,24,20_contrasted.png,1024,1448,522,962
3975,text,56,962,404,26,20_contrasted.png,1024,1448,460,988
3976,text,277,1323,96,20,20_contrasted.png,1024,1448,373,1343
3977,text,381,1323,349,20,20_contrasted.png,1024,1448,730,1343
3978,text,273,1345,84,18,20_contrasted.png,1024,1448,357,1363
3979,text,367,1345,100,18,20_contrasted.png,1024,1448,467,1363
3980,text,475,1345,262,20,20_contrasted.png,1024,1448,737,1365
3981,text,429,680,26,28,20_contrasted.png,1024,1448,455,708
3982,text,432,606,22,22,20_contrasted.png,1024,1448,454,628
3983,text,190,40,482,76,20_denoise.png,1024,1448,672,116
3984,text,686,72,28,26,20_denoise.png,1024,1448,714,98
3985,text,722,42,134,74,20_denoise.png,1024,1448,856,116
3986,text,657,358,225,26,20_denoise.png,1024,1448,882,384
3987,text,125,431,139,40,20_denoise.png,1024,1448,264,471
3988,text,277,431,524,44,20_denoise.png,1024,1448,801,475
3989,text,374,482,196,24,20_denoise.png,1024,1448,570,506
3990,text,318,554,252,26,20_denoise.png,1024,1448,570,580
3991,text,163,602,121,29,20_denoise.png,1024,1448,284,631
3992,text,533,609,38,20,20_denoise.png,1024,1448,571,629
3993,text,616,606,90,24,20_denoise.png,1024,1448,706,630
3994,text,746,608,102,24,20_denoise.png,1024,1448,848,632
3995,text,80,680,282,26,20_denoise.png,1024,1448,362,706
3996,text,524,684,52,24,20_denoise.png,1024,1448,576,708
3997,text,636,686,46,24,20_denoise.png,1024,1448,682,710
3998,text,756,686,80,26,20_denoise.png,1024,1448,836,712
3999,text,328,812,116,26,20_denoise.png,1024,1448,444,838
4000,text,754,816,82,26,20_denoise.png,1024,1448,836,842
4001,text,338,840,94,24,20_denoise.png,1024,1448,432,864
4002,text,760,842,70,26,20_denoise.png,1024,1448,830,868
4003,text,322,864,126,26,20_denoise.png,1024,1448,448,890
4004,text,752,868,82,26,20_denoise.png,1024,1448,834,894
4005,text,62,938,460,24,20_denoise.png,1024,1448,522,962
4006,text,56,962,404,26,20_denoise.png,1024,1448,460,988
4007,text,277,1323,96,20,20_denoise.png,1024,1448,373,1343
4008,text,381,1323,349,20,20_denoise.png,1024,1448,730,1343
4009,text,273,1345,84,18,20_denoise.png,1024,1448,357,1363
4010,text,367,1345,100,18,20_denoise.png,1024,1448,467,1363
4011,text,475,1345,262,20,20_denoise.png,1024,1448,737,1365
4012,text,429,680,26,28,20_denoise.png,1024,1448,455,708
4013,text,432,606,22,22,20_denoise.png,1024,1448,454,628
4014,text,190,40,482,76,20_median.png,1024,1448,672,116
4015,text,686,72,28,26,20_median.png,1024,1448,714,98
4016,text,722,42,134,74,20_median.png,1024,1448,856,116
4017,text,657,358,225,26,20_median.png,1024,1448,882,384
4018,text,125,431,139,40,20_median.png,1024,1448,264,471
4019,text,277,431,524,44,20_median.png,1024,1448,801,475
4020,text,374,482,196,24,20_median.png,1024,1448,570,506
4021,text,318,554,252,26,20_median.png,1024,1448,570,580
4022,text,163,602,121,29,20_median.png,1024,1448,284,631
4023,text,533,609,38,20,20_median.png,1024,1448,571,629
4024,text,616,606,90,24,20_median.png,1024,1448,706,630
4025,text,746,608,102,24,20_median.png,1024,1448,848,632
4026,text,80,680,282,26,20_median.png,1024,1448,362,706
4027,text,524,684,52,24,20_median.png,1024,1448,576,708
4028,text,636,686,46,24,20_median.png,1024,1448,682,710
4029,text,756,686,80,26,20_median.png,1024,1448,836,712
4030,text,328,812,116,26,20_median.png,1024,1448,444,838
4031,text,754,816,82,26,20_median.png,1024,1448,836,842
4032,text,338,840,94,24,20_median.png,1024,1448,432,864
4033,text,760,842,70,26,20_median.png,1024,1448,830,868
4034,text,322,864,126,26,20_median.png,1024,1448,448,890
4035,text,752,868,82,26,20_median.png,1024,1448,834,894
4036,text,62,938,460,24,20_median.png,1024,1448,522,962
4037,text,56,962,404,26,20_median.png,1024,1448,460,988
4038,text,277,1323,96,20,20_median.png,1024,1448,373,1343
4039,text,381,1323,349,20,20_median.png,1024,1448,730,1343
4040,text,273,1345,84,18,20_median.png,1024,1448,357,1363
4041,text,367,1345,100,18,20_median.png,1024,1448,467,1363
4042,text,475,1345,262,20,20_median.png,1024,1448,737,1365
4043,text,429,680,26,28,20_median.png,1024,1448,455,708
4044,text,432,606,22,22,20_median.png,1024,1448,454,628
4045,text,657,87,148,20,21.png,1024,1430,805,107
4046,text,675,115,116,20,21.png,1024,1430,791,135
4047,text,639,215,32,20,21.png,1024,1430,671,235
4048,text,681,215,142,20,21.png,1024,1430,823,235
4049,text,71,289,30,16,21.png,1024,1430,101,305
4050,text,110,284,128,24,21.png,1024,1430,238,308
4051,text,247,289,24,16,21.png,1024,1430,271,305
4052,text,577,281,81,20,21.png,1024,1430,658,301
4053,text,795,280,88,20,21.png,1024,1430,883,300
4054,text,256,338,102,24,21.png,1024,1430,358,362
4055,text,589,343,72,20,21.png,1024,1430,661,363
4056,text,693,343,68,18,21.png,1024,1430,761,361
4057,text,813,341,106,20,21.png,1024,1430,919,361
4058,text,62,374,204,24,21.png,1024,1430,266,398
4059,text,719,375,56,20,21.png,1024,1430,775,395
4060,text,877,375,68,20,21.png,1024,1430,945,395
4061,text,389,887,168,20,21.png,1024,1430,557,907
4062,text,567,887,64,20,21.png,1024,1430,631,907
4063,text,103,923,120,20,21.png,1024,1430,223,943
4064,text,335,925,94,20,21.png,1024,1430,429,945
4065,text,514,925,86,18,21.png,1024,1430,600,943
4066,text,605,927,44,16,21.png,1024,1430,649,943
4067,text,710,923,205,20,21.png,1024,1430,915,943
4068,text,131,949,68,20,21.png,1024,1430,199,969
4069,text,363,949,38,20,21.png,1024,1430,401,969
4070,text,557,949,56,18,21.png,1024,1430,613,967
4071,text,779,949,68,18,21.png,1024,1430,847,967
4072,text,62,980,326,24,21.png,1024,1430,388,1004
4073,text,585,983,202,20,21.png,1024,1430,787,1003
4074,text,65,1005,190,20,21.png,1024,1430,255,1025
4075,text,311,1101,196,20,21.png,1024,1430,507,1121
4076,text,513,1098,183,24,21.png,1024,1430,696,1122
4077,text,283,1122,440,18,21.png,1024,1430,723,1140
4078,text,273,1140,458,19,21.png,1024,1430,731,1159
4079,text,112,1159,780,18,21.png,1024,1430,892,1177
4080,text,145,1177,119,20,21.png,1024,1430,264,1197
4081,text,268,1178,594,18,21.png,1024,1430,862,1196
4082,text,295,1196,421,21,21.png,1024,1430,716,1217
4083,text,213,1237,156,16,21.png,1024,1430,369,1253
4084,text,370,1234,420,20,21.png,1024,1430,790,1254
4085,text,233,1253,82,20,21.png,1024,1430,315,1273
4086,text,365,1253,402,21,21.png,1024,1430,767,1274
4087,text,69,1287,84,20,21.png,1024,1430,153,1307
4088,text,163,1287,152,20,21.png,1024,1430,315,1307
4089,text,321,1289,182,18,21.png,1024,1430,503,1307
4090,text,509,1287,244,18,21.png,1024,1430,753,1305
4091,text,769,1291,28,14,21.png,1024,1430,797,1305
4092,text,798,1285,109,21,21.png,1024,1430,907,1306
4093,text,335,1305,32,20,21.png,1024,1430,367,1325
4094,text,377,1305,142,20,21.png,1024,1430,519,1325
4095,text,529,1307,88,18,21.png,1024,1430,617,1325
4096,text,623,1307,120,18,21.png,1024,1430,743,1325
4097,text,96,1324,212,24,21.png,1024,1430,308,1348
4098,text,315,1325,116,20,21.png,1024,1430,431,1345
4099,text,436,1324,282,24,21.png,1024,1430,718,1348
4100,text,779,1328,110,16,21.png,1024,1430,889,1344
4101,text,315,1255,51,18,21.png,1024,1430,366,1273
4102,text,617,378,19,18,21.png,1024,1430,636,396
4103,text,662,281,122,22,21.png,1024,1430,784,303
4104,text,657,87,148,20,21_contrasted.png,1024,1430,805,107
4105,text,675,115,116,20,21_contrasted.png,1024,1430,791,135
4106,text,639,215,32,20,21_contrasted.png,1024,1430,671,235
4107,text,681,215,142,20,21_contrasted.png,1024,1430,823,235
4108,text,71,289,30,16,21_contrasted.png,1024,1430,101,305
4109,text,110,284,128,24,21_contrasted.png,1024,1430,238,308
4110,text,247,289,24,16,21_contrasted.png,1024,1430,271,305
4111,text,577,281,81,20,21_contrasted.png,1024,1430,658,301
4112,text,795,280,88,20,21_contrasted.png,1024,1430,883,300
4113,text,256,338,102,24,21_contrasted.png,1024,1430,358,362
4114,text,589,343,72,20,21_contrasted.png,1024,1430,661,363
4115,text,693,343,68,18,21_contrasted.png,1024,1430,761,361
4116,text,813,341,106,20,21_contrasted.png,1024,1430,919,361
4117,text,62,374,204,24,21_contrasted.png,1024,1430,266,398
4118,text,719,375,56,20,21_contrasted.png,1024,1430,775,395
4119,text,877,375,68,20,21_contrasted.png,1024,1430,945,395
4120,text,389,887,168,20,21_contrasted.png,1024,1430,557,907
4121,text,567,887,64,20,21_contrasted.png,1024,1430,631,907
4122,text,103,923,120,20,21_contrasted.png,1024,1430,223,943
4123,text,335,925,94,20,21_contrasted.png,1024,1430,429,945
4124,text,514,925,86,18,21_contrasted.png,1024,1430,600,943
4125,text,605,927,44,16,21_contrasted.png,1024,1430,649,943
4126,text,710,923,205,20,21_contrasted.png,1024,1430,915,943
4127,text,131,949,68,20,21_contrasted.png,1024,1430,199,969
4128,text,363,949,38,20,21_contrasted.png,1024,1430,401,969
4129,text,557,949,56,18,21_contrasted.png,1024,1430,613,967
4130,text,779,949,68,18,21_contrasted.png,1024,1430,847,967
4131,text,62,980,326,24,21_contrasted.png,1024,1430,388,1004
4132,text,585,983,202,20,21_contrasted.png,1024,1430,787,1003
4133,text,65,1005,190,20,21_contrasted.png,1024,1430,255,1025
4134,text,311,1101,196,20,21_contrasted.png,1024,1430,507,1121
4135,text,513,1098,183,24,21_contrasted.png,1024,1430,696,1122
4136,text,283,1122,440,18,21_contrasted.png,1024,1430,723,1140
4137,text,273,1140,458,19,21_contrasted.png,1024,1430,731,1159
4138,text,112,1159,780,18,21_contrasted.png,1024,1430,892,1177
4139,text,145,1177,119,20,21_contrasted.png,1024,1430,264,1197
4140,text,268,1178,594,18,21_contrasted.png,1024,1430,862,1196
4141,text,295,1196,421,21,21_contrasted.png,1024,1430,716,1217
4142,text,213,1237,156,16,21_contrasted.png,1024,1430,369,1253
4143,text,370,1234,420,20,21_contrasted.png,1024,1430,790,1254
4144,text,233,1253,82,20,21_contrasted.png,1024,1430,315,1273
4145,text,365,1253,402,21,21_contrasted.png,1024,1430,767,1274
4146,text,69,1287,84,20,21_contrasted.png,1024,1430,153,1307
4147,text,163,1287,152,20,21_contrasted.png,1024,1430,315,1307
4148,text,321,1289,182,18,21_contrasted.png,1024,1430,503,1307
4149,text,509,1287,244,18,21_contrasted.png,1024,1430,753,1305
4150,text,769,1291,28,14,21_contrasted.png,1024,1430,797,1305
4151,text,798,1285,109,21,21_contrasted.png,1024,1430,907,1306
4152,text,335,1305,32,20,21_contrasted.png,1024,1430,367,1325
4153,text,377,1305,142,20,21_contrasted.png,1024,1430,519,1325
4154,text,529,1307,88,18,21_contrasted.png,1024,1430,617,1325
4155,text,623,1307,120,18,21_contrasted.png,1024,1430,743,1325
4156,text,96,1324,212,24,21_contrasted.png,1024,1430,308,1348
4157,text,315,1325,116,20,21_contrasted.png,1024,1430,431,1345
4158,text,436,1324,282,24,21_contrasted.png,1024,1430,718,1348
4159,text,779,1328,110,16,21_contrasted.png,1024,1430,889,1344
4160,text,315,1255,51,18,21_contrasted.png,1024,1430,366,1273
4161,text,617,378,19,18,21_contrasted.png,1024,1430,636,396
4162,text,662,281,122,22,21_contrasted.png,1024,1430,784,303
4163,text,657,87,148,20,21_denoise.png,1024,1430,805,107
4164,text,675,115,116,20,21_denoise.png,1024,1430,791,135
4165,text,639,215,32,20,21_denoise.png,1024,1430,671,235
4166,text,681,215,142,20,21_denoise.png,1024,1430,823,235
4167,text,71,289,30,16,21_denoise.png,1024,1430,101,305
4168,text,110,284,128,24,21_denoise.png,1024,1430,238,308
4169,text,247,289,24,16,21_denoise.png,1024,1430,271,305
4170,text,577,281,81,20,21_denoise.png,1024,1430,658,301
4171,text,795,280,88,20,21_denoise.png,1024,1430,883,300
4172,text,256,338,102,24,21_denoise.png,1024,1430,358,362
4173,text,589,343,72,20,21_denoise.png,1024,1430,661,363
4174,text,693,343,68,18,21_denoise.png,1024,1430,761,361
4175,text,813,341,106,20,21_denoise.png,1024,1430,919,361
4176,text,62,374,204,24,21_denoise.png,1024,1430,266,398
4177,text,719,375,56,20,21_denoise.png,1024,1430,775,395
4178,text,877,375,68,20,21_denoise.png,1024,1430,945,395
4179,text,389,887,168,20,21_denoise.png,1024,1430,557,907
4180,text,567,887,64,20,21_denoise.png,1024,1430,631,907
4181,text,103,923,120,20,21_denoise.png,1024,1430,223,943
4182,text,335,925,94,20,21_denoise.png,1024,1430,429,945
4183,text,514,925,86,18,21_denoise.png,1024,1430,600,943
4184,text,605,927,44,16,21_denoise.png,1024,1430,649,943
4185,text,710,923,205,20,21_denoise.png,1024,1430,915,943
4186,text,131,949,68,20,21_denoise.png,1024,1430,199,969
4187,text,363,949,38,20,21_denoise.png,1024,1430,401,969
4188,text,557,949,56,18,21_denoise.png,1024,1430,613,967
4189,text,779,949,68,18,21_denoise.png,1024,1430,847,967
4190,text,62,980,326,24,21_denoise.png,1024,1430,388,1004
4191,text,585,983,202,20,21_denoise.png,1024,1430,787,1003
4192,text,65,1005,190,20,21_denoise.png,1024,1430,255,1025
4193,text,311,1101,196,20,21_denoise.png,1024,1430,507,1121
4194,text,513,1098,183,24,21_denoise.png,1024,1430,696,1122
4195,text,283,1122,440,18,21_denoise.png,1024,1430,723,1140
4196,text,273,1140,458,19,21_denoise.png,1024,1430,731,1159
4197,text,112,1159,780,18,21_denoise.png,1024,1430,892,1177
4198,text,145,1177,119,20,21_denoise.png,1024,1430,264,1197
4199,text,268,1178,594,18,21_denoise.png,1024,1430,862,1196
4200,text,295,1196,421,21,21_denoise.png,1024,1430,716,1217
4201,text,213,1237,156,16,21_denoise.png,1024,1430,369,1253
4202,text,370,1234,420,20,21_denoise.png,1024,1430,790,1254
4203,text,233,1253,82,20,21_denoise.png,1024,1430,315,1273
4204,text,365,1253,402,21,21_denoise.png,1024,1430,767,1274
4205,text,69,1287,84,20,21_denoise.png,1024,1430,153,1307
4206,text,163,1287,152,20,21_denoise.png,1024,1430,315,1307
4207,text,321,1289,182,18,21_denoise.png,1024,1430,503,1307
4208,text,509,1287,244,18,21_denoise.png,1024,1430,753,1305
4209,text,769,1291,28,14,21_denoise.png,1024,1430,797,1305
4210,text,798,1285,109,21,21_denoise.png,1024,1430,907,1306
4211,text,335,1305,32,20,21_denoise.png,1024,1430,367,1325
4212,text,377,1305,142,20,21_denoise.png,1024,1430,519,1325
4213,text,529,1307,88,18,21_denoise.png,1024,1430,617,1325
4214,text,623,1307,120,18,21_denoise.png,1024,1430,743,1325
4215,text,96,1324,212,24,21_denoise.png,1024,1430,308,1348
4216,text,315,1325,116,20,21_denoise.png,1024,1430,431,1345
4217,text,436,1324,282,24,21_denoise.png,1024,1430,718,1348
4218,text,779,1328,110,16,21_denoise.png,1024,1430,889,1344
4219,text,315,1255,51,18,21_denoise.png,1024,1430,366,1273
4220,text,617,378,19,18,21_denoise.png,1024,1430,636,396
4221,text,662,281,122,22,21_denoise.png,1024,1430,784,303
4222,text,657,87,148,20,21_median.png,1024,1430,805,107
4223,text,675,115,116,20,21_median.png,1024,1430,791,135
4224,text,639,215,32,20,21_median.png,1024,1430,671,235
4225,text,681,215,142,20,21_median.png,1024,1430,823,235
4226,text,71,289,30,16,21_median.png,1024,1430,101,305
4227,text,110,284,128,24,21_median.png,1024,1430,238,308
4228,text,247,289,24,16,21_median.png,1024,1430,271,305
4229,text,577,281,81,20,21_median.png,1024,1430,658,301
4230,text,795,280,88,20,21_median.png,1024,1430,883,300
4231,text,256,338,102,24,21_median.png,1024,1430,358,362
4232,text,589,343,72,20,21_median.png,1024,1430,661,363
4233,text,693,343,68,18,21_median.png,1024,1430,761,361
4234,text,813,341,106,20,21_median.png,1024,1430,919,361
4235,text,62,374,204,24,21_median.png,1024,1430,266,398
4236,text,719,375,56,20,21_median.png,1024,1430,775,395
4237,text,877,375,68,20,21_median.png,1024,1430,945,395
4238,text,389,887,168,20,21_median.png,1024,1430,557,907
4239,text,567,887,64,20,21_median.png,1024,1430,631,907
4240,text,103,923,120,20,21_median.png,1024,1430,223,943
4241,text,335,925,94,20,21_median.png,1024,1430,429,945
4242,text,514,925,86,18,21_median.png,1024,1430,600,943
4243,text,605,927,44,16,21_median.png,1024,1430,649,943
4244,text,710,923,205,20,21_median.png,1024,1430,915,943
4245,text,131,949,68,20,21_median.png,1024,1430,199,969
4246,text,363,949,38,20,21_median.png,1024,1430,401,969
4247,text,557,949,56,18,21_median.png,1024,1430,613,967
4248,text,779,949,68,18,21_median.png,1024,1430,847,967
4249,text,62,980,326,24,21_median.png,1024,1430,388,1004
4250,text,585,983,202,20,21_median.png,1024,1430,787,1003
4251,text,65,1005,190,20,21_median.png,1024,1430,255,1025
4252,text,311,1101,196,20,21_median.png,1024,1430,507,1121
4253,text,513,1098,183,24,21_median.png,1024,1430,696,1122
4254,text,283,1122,440,18,21_median.png,1024,1430,723,1140
4255,text,273,1140,458,19,21_median.png,1024,1430,731,1159
4256,text,112,1159,780,18,21_median.png,1024,1430,892,1177
4257,text,145,1177,119,20,21_median.png,1024,1430,264,1197
4258,text,268,1178,594,18,21_median.png,1024,1430,862,1196
4259,text,295,1196,421,21,21_median.png,1024,1430,716,1217
4260,text,213,1237,156,16,21_median.png,1024,1430,369,1253
4261,text,370,1234,420,20,21_median.png,1024,1430,790,1254
4262,text,233,1253,82,20,21_median.png,1024,1430,315,1273
4263,text,365,1253,402,21,21_median.png,1024,1430,767,1274
4264,text,69,1287,84,20,21_median.png,1024,1430,153,1307
4265,text,163,1287,152,20,21_median.png,1024,1430,315,1307
4266,text,321,1289,182,18,21_median.png,1024,1430,503,1307
4267,text,509,1287,244,18,21_median.png,1024,1430,753,1305
4268,text,769,1291,28,14,21_median.png,1024,1430,797,1305
4269,text,798,1285,109,21,21_median.png,1024,1430,907,1306
4270,text,335,1305,32,20,21_median.png,1024,1430,367,1325
4271,text,377,1305,142,20,21_median.png,1024,1430,519,1325
4272,text,529,1307,88,18,21_median.png,1024,1430,617,1325
4273,text,623,1307,120,18,21_median.png,1024,1430,743,1325
4274,text,96,1324,212,24,21_median.png,1024,1430,308,1348
4275,text,315,1325,116,20,21_median.png,1024,1430,431,1345
4276,text,436,1324,282,24,21_median.png,1024,1430,718,1348
4277,text,779,1328,110,16,21_median.png,1024,1430,889,1344
4278,text,315,1255,51,18,21_median.png,1024,1430,366,1273
4279,text,617,378,19,18,21_median.png,1024,1430,636,396
4280,text,662,281,122,22,21_median.png,1024,1430,784,303
4281,text,679,99,130,18,22.png,1024,1430,809,117
4282,text,679,119,90,16,22.png,1024,1430,769,135
4283,text,773,119,100,16,22.png,1024,1430,873,135
4284,text,202,138,74,24,22.png,1024,1430,276,162
4285,text,428,136,118,24,22.png,1024,1430,546,160
4286,text,679,139,114,16,22.png,1024,1430,793,155
4287,text,460,156,55,20,22.png,1024,1430,515,176
4288,text,679,159,62,16,22.png,1024,1430,741,175
4289,text,749,159,118,16,22.png,1024,1430,867,175
4290,text,873,159,42,16,22.png,1024,1430,915,175
4291,text,81,263,270,21,22.png,1024,1430,351,284
4292,text,123,289,66,16,22.png,1024,1430,189,305
4293,text,241,289,112,16,22.png,1024,1430,353,305
4294,text,411,287,54,16,22.png,1024,1430,465,303
4295,text,559,289,64,16,22.png,1024,1430,623,305
4296,text,117,311,78,16,22.png,1024,1430,195,327
4297,text,261,311,70,16,22.png,1024,1430,331,327
4298,text,413,311,48,16,22.png,1024,1430,461,327
4299,text,559,305,207,20,22.png,1024,1430,766,325
4300,text,771,308,70,17,22.png,1024,1430,841,325
4301,text,557,325,96,20,22.png,1024,1430,653,345
4302,text,95,337,308,16,22.png,1024,1430,403,353
4303,text,95,355,62,16,22.png,1024,1430,157,371
4304,text,165,355,118,16,22.png,1024,1430,283,371
4305,text,289,357,42,14,22.png,1024,1430,331,371
4306,text,93,372,183,24,22.png,1024,1430,276,396
4307,text,93,393,220,20,22.png,1024,1430,313,413
4308,text,93,478,154,18,22.png,1024,1430,247,496
4309,text,557,479,218,16,22.png,1024,1430,775,495
4310,text,91,499,150,16,22.png,1024,1430,241,515
4311,text,249,499,54,16,22.png,1024,1430,303,515
4312,text,311,497,70,18,22.png,1024,1430,381,515
4313,text,557,499,64,16,22.png,1024,1430,621,515
4314,text,91,519,64,16,22.png,1024,1430,155,535
4315,text,557,519,207,16,22.png,1024,1430,764,535
4316,text,767,517,72,18,22.png,1024,1430,839,535
4317,text,89,535,40,20,22.png,1024,1430,129,555
4318,text,557,539,92,16,22.png,1024,1430,649,555
4319,text,89,555,84,20,22.png,1024,1430,173,575
4320,text,557,559,170,16,22.png,1024,1430,727,575
4321,text,91,579,166,18,22.png,1024,1430,257,597
4322,text,553,577,28,18,22.png,1024,1430,581,595
4323,text,602,578,114,16,22.png,1024,1430,716,594
4324,text,314,636,284,26,22.png,1024,1430,598,662
4325,text,855,645,62,16,22.png,1024,1430,917,661
4326,text,245,671,112,16,22.png,1024,1430,357,687
4327,text,543,671,52,14,22.png,1024,1430,595,685
4328,text,633,671,36,14,22.png,1024,1430,669,685
4329,text,703,671,74,16,22.png,1024,1430,777,687
4330,text,823,671,74,16,22.png,1024,1430,897,687
4331,text,89,693,224,18,22.png,1024,1430,313,711
4332,text,89,717,232,16,22.png,1024,1430,321,733
4333,text,89,739,148,16,22.png,1024,1430,237,755
4334,text,559,739,46,16,22.png,1024,1430,605,755
4335,text,629,739,42,18,22.png,1024,1430,671,757
4336,text,739,741,44,16,22.png,1024,1430,783,757
4337,text,859,741,56,16,22.png,1024,1430,915,757
4338,text,537,955,116,16,22.png,1024,1430,653,971
4339,text,787,953,88,18,22.png,1024,1430,875,971
4340,text,89,993,154,20,22.png,1024,1430,243,1013
4341,text,387,995,90,16,22.png,1024,1430,477,1011
4342,text,535,995,98,16,22.png,1024,1430,633,1011
4343,text,779,995,96,16,22.png,1024,1430,875,1011
4344,text,87,1039,106,16,22.png,1024,1430,193,1055
4345,text,215,1035,330,18,22.png,1024,1430,545,1053
4346,text,553,1037,184,18,22.png,1024,1430,737,1055
4347,text,90,1232,144,24,22.png,1024,1430,234,1256
4348,text,245,1233,120,20,22.png,1024,1430,365,1253
4349,text,569,1233,32,20,22.png,1024,1430,601,1253
4350,text,607,1239,22,14,22.png,1024,1430,629,1253
4351,text,626,1232,238,24,22.png,1024,1430,864,1256
4352,text,87,1251,169,26,22.png,1024,1430,256,1277
4353,text,568,1252,188,24,22.png,1024,1430,756,1276
4354,text,762,1252,120,24,22.png,1024,1430,882,1276
4355,text,569,1275,28,18,22.png,1024,1430,597,1293
4356,text,607,1275,88,18,22.png,1024,1430,695,1293
4357,text,702,1272,126,24,22.png,1024,1430,828,1296
4358,text,566,1292,182,24,22.png,1024,1430,748,1316
4359,text,89,1359,718,21,22.png,1024,1430,807,1380
4360,text,848,518,20,18,22.png,1024,1430,868,536
4361,text,846,309,25,16,22.png,1024,1430,871,325
4362,text,679,99,130,18,22_contrasted.png,1024,1430,809,117
4363,text,679,119,90,16,22_contrasted.png,1024,1430,769,135
4364,text,773,119,100,16,22_contrasted.png,1024,1430,873,135
4365,text,202,138,74,24,22_contrasted.png,1024,1430,276,162
4366,text,428,136,118,24,22_contrasted.png,1024,1430,546,160
4367,text,679,139,114,16,22_contrasted.png,1024,1430,793,155
4368,text,460,156,55,20,22_contrasted.png,1024,1430,515,176
4369,text,679,159,62,16,22_contrasted.png,1024,1430,741,175
4370,text,749,159,118,16,22_contrasted.png,1024,1430,867,175
4371,text,873,159,42,16,22_contrasted.png,1024,1430,915,175
4372,text,81,263,270,21,22_contrasted.png,1024,1430,351,284
4373,text,123,289,66,16,22_contrasted.png,1024,1430,189,305
4374,text,241,289,112,16,22_contrasted.png,1024,1430,353,305
4375,text,411,287,54,16,22_contrasted.png,1024,1430,465,303
4376,text,559,289,64,16,22_contrasted.png,1024,1430,623,305
4377,text,117,311,78,16,22_contrasted.png,1024,1430,195,327
4378,text,261,311,70,16,22_contrasted.png,1024,1430,331,327
4379,text,413,311,48,16,22_contrasted.png,1024,1430,461,327
4380,text,559,305,207,20,22_contrasted.png,1024,1430,766,325
4381,text,771,308,70,17,22_contrasted.png,1024,1430,841,325
4382,text,557,325,96,20,22_contrasted.png,1024,1430,653,345
4383,text,95,337,308,16,22_contrasted.png,1024,1430,403,353
4384,text,95,355,62,16,22_contrasted.png,1024,1430,157,371
4385,text,165,355,118,16,22_contrasted.png,1024,1430,283,371
4386,text,289,357,42,14,22_contrasted.png,1024,1430,331,371
4387,text,93,372,183,24,22_contrasted.png,1024,1430,276,396
4388,text,93,393,220,20,22_contrasted.png,1024,1430,313,413
4389,text,93,478,154,18,22_contrasted.png,1024,1430,247,496
4390,text,557,479,218,16,22_contrasted.png,1024,1430,775,495
4391,text,91,499,150,16,22_contrasted.png,1024,1430,241,515
4392,text,249,499,54,16,22_contrasted.png,1024,1430,303,515
4393,text,311,497,70,18,22_contrasted.png,1024,1430,381,515
4394,text,557,499,64,16,22_contrasted.png,1024,1430,621,515
4395,text,91,519,64,16,22_contrasted.png,1024,1430,155,535
4396,text,557,519,207,16,22_contrasted.png,1024,1430,764,535
4397,text,767,517,72,18,22_contrasted.png,1024,1430,839,535
4398,text,89,535,40,20,22_contrasted.png,1024,1430,129,555
4399,text,557,539,92,16,22_contrasted.png,1024,1430,649,555
4400,text,89,555,84,20,22_contrasted.png,1024,1430,173,575
4401,text,557,559,170,16,22_contrasted.png,1024,1430,727,575
4402,text,91,579,166,18,22_contrasted.png,1024,1430,257,597
4403,text,553,577,28,18,22_contrasted.png,1024,1430,581,595
4404,text,602,578,114,16,22_contrasted.png,1024,1430,716,594
4405,text,314,636,284,26,22_contrasted.png,1024,1430,598,662
4406,text,855,645,62,16,22_contrasted.png,1024,1430,917,661
4407,text,245,671,112,16,22_contrasted.png,1024,1430,357,687
4408,text,543,671,52,14,22_contrasted.png,1024,1430,595,685
4409,text,633,671,36,14,22_contrasted.png,1024,1430,669,685
4410,text,703,671,74,16,22_contrasted.png,1024,1430,777,687
4411,text,823,671,74,16,22_contrasted.png,1024,1430,897,687
4412,text,89,693,224,18,22_contrasted.png,1024,1430,313,711
4413,text,89,717,232,16,22_contrasted.png,1024,1430,321,733
4414,text,89,739,148,16,22_contrasted.png,1024,1430,237,755
4415,text,559,739,46,16,22_contrasted.png,1024,1430,605,755
4416,text,629,739,42,18,22_contrasted.png,1024,1430,671,757
4417,text,739,741,44,16,22_contrasted.png,1024,1430,783,757
4418,text,859,741,56,16,22_contrasted.png,1024,1430,915,757
4419,text,537,955,116,16,22_contrasted.png,1024,1430,653,971
4420,text,787,953,88,18,22_contrasted.png,1024,1430,875,971
4421,text,89,993,154,20,22_contrasted.png,1024,1430,243,1013
4422,text,387,995,90,16,22_contrasted.png,1024,1430,477,1011
4423,text,535,995,98,16,22_contrasted.png,1024,1430,633,1011
4424,text,779,995,96,16,22_contrasted.png,1024,1430,875,1011
4425,text,87,1039,106,16,22_contrasted.png,1024,1430,193,1055
4426,text,215,1035,330,18,22_contrasted.png,1024,1430,545,1053
4427,text,553,1037,184,18,22_contrasted.png,1024,1430,737,1055
4428,text,90,1232,144,24,22_contrasted.png,1024,1430,234,1256
4429,text,245,1233,120,20,22_contrasted.png,1024,1430,365,1253
4430,text,569,1233,32,20,22_contrasted.png,1024,1430,601,1253
4431,text,607,1239,22,14,22_contrasted.png,1024,1430,629,1253
4432,text,626,1232,238,24,22_contrasted.png,1024,1430,864,1256
4433,text,87,1251,169,26,22_contrasted.png,1024,1430,256,1277
4434,text,568,1252,188,24,22_contrasted.png,1024,1430,756,1276
4435,text,762,1252,120,24,22_contrasted.png,1024,1430,882,1276
4436,text,569,1275,28,18,22_contrasted.png,1024,1430,597,1293
4437,text,607,1275,88,18,22_contrasted.png,1024,1430,695,1293
4438,text,702,1272,126,24,22_contrasted.png,1024,1430,828,1296
4439,text,566,1292,182,24,22_contrasted.png,1024,1430,748,1316
4440,text,89,1359,718,21,22_contrasted.png,1024,1430,807,1380
4441,text,848,518,20,18,22_contrasted.png,1024,1430,868,536
4442,text,846,309,25,16,22_contrasted.png,1024,1430,871,325
4443,text,679,99,130,18,22_denoise.png,1024,1430,809,117
4444,text,679,119,90,16,22_denoise.png,1024,1430,769,135
4445,text,773,119,100,16,22_denoise.png,1024,1430,873,135
4446,text,202,138,74,24,22_denoise.png,1024,1430,276,162
4447,text,428,136,118,24,22_denoise.png,1024,1430,546,160
4448,text,679,139,114,16,22_denoise.png,1024,1430,793,155
4449,text,460,156,55,20,22_denoise.png,1024,1430,515,176
4450,text,679,159,62,16,22_denoise.png,1024,1430,741,175
4451,text,749,159,118,16,22_denoise.png,1024,1430,867,175
4452,text,873,159,42,16,22_denoise.png,1024,1430,915,175
4453,text,81,263,270,21,22_denoise.png,1024,1430,351,284
4454,text,123,289,66,16,22_denoise.png,1024,1430,189,305
4455,text,241,289,112,16,22_denoise.png,1024,1430,353,305
4456,text,411,287,54,16,22_denoise.png,1024,1430,465,303
4457,text,559,289,64,16,22_denoise.png,1024,1430,623,305
4458,text,117,311,78,16,22_denoise.png,1024,1430,195,327
4459,text,261,311,70,16,22_denoise.png,1024,1430,331,327
4460,text,413,311,48,16,22_denoise.png,1024,1430,461,327
4461,text,559,305,207,20,22_denoise.png,1024,1430,766,325
4462,text,771,308,70,17,22_denoise.png,1024,1430,841,325
4463,text,557,325,96,20,22_denoise.png,1024,1430,653,345
4464,text,95,337,308,16,22_denoise.png,1024,1430,403,353
4465,text,95,355,62,16,22_denoise.png,1024,1430,157,371
4466,text,165,355,118,16,22_denoise.png,1024,1430,283,371
4467,text,289,357,42,14,22_denoise.png,1024,1430,331,371
4468,text,93,372,183,24,22_denoise.png,1024,1430,276,396
4469,text,93,393,220,20,22_denoise.png,1024,1430,313,413
4470,text,93,478,154,18,22_denoise.png,1024,1430,247,496
4471,text,557,479,218,16,22_denoise.png,1024,1430,775,495
4472,text,91,499,150,16,22_denoise.png,1024,1430,241,515
4473,text,249,499,54,16,22_denoise.png,1024,1430,303,515
4474,text,311,497,70,18,22_denoise.png,1024,1430,381,515
4475,text,557,499,64,16,22_denoise.png,1024,1430,621,515
4476,text,91,519,64,16,22_denoise.png,1024,1430,155,535
4477,text,557,519,207,16,22_denoise.png,1024,1430,764,535
4478,text,767,517,72,18,22_denoise.png,1024,1430,839,535
4479,text,89,535,40,20,22_denoise.png,1024,1430,129,555
4480,text,557,539,92,16,22_denoise.png,1024,1430,649,555
4481,text,89,555,84,20,22_denoise.png,1024,1430,173,575
4482,text,557,559,170,16,22_denoise.png,1024,1430,727,575
4483,text,91,579,166,18,22_denoise.png,1024,1430,257,597
4484,text,553,577,28,18,22_denoise.png,1024,1430,581,595
4485,text,602,578,114,16,22_denoise.png,1024,1430,716,594
4486,text,314,636,284,26,22_denoise.png,1024,1430,598,662
4487,text,855,645,62,16,22_denoise.png,1024,1430,917,661
4488,text,245,671,112,16,22_denoise.png,1024,1430,357,687
4489,text,543,671,52,14,22_denoise.png,1024,1430,595,685
4490,text,633,671,36,14,22_denoise.png,1024,1430,669,685
4491,text,703,671,74,16,22_denoise.png,1024,1430,777,687
4492,text,823,671,74,16,22_denoise.png,1024,1430,897,687
4493,text,89,693,224,18,22_denoise.png,1024,1430,313,711
4494,text,89,717,232,16,22_denoise.png,1024,1430,321,733
4495,text,89,739,148,16,22_denoise.png,1024,1430,237,755
4496,text,559,739,46,16,22_denoise.png,1024,1430,605,755
4497,text,629,739,42,18,22_denoise.png,1024,1430,671,757
4498,text,739,741,44,16,22_denoise.png,1024,1430,783,757
4499,text,859,741,56,16,22_denoise.png,1024,1430,915,757
4500,text,537,955,116,16,22_denoise.png,1024,1430,653,971
4501,text,787,953,88,18,22_denoise.png,1024,1430,875,971
4502,text,89,993,154,20,22_denoise.png,1024,1430,243,1013
4503,text,387,995,90,16,22_denoise.png,1024,1430,477,1011
4504,text,535,995,98,16,22_denoise.png,1024,1430,633,1011
4505,text,779,995,96,16,22_denoise.png,1024,1430,875,1011
4506,text,87,1039,106,16,22_denoise.png,1024,1430,193,1055
4507,text,215,1035,330,18,22_denoise.png,1024,1430,545,1053
4508,text,553,1037,184,18,22_denoise.png,1024,1430,737,1055
4509,text,90,1232,144,24,22_denoise.png,1024,1430,234,1256
4510,text,245,1233,120,20,22_denoise.png,1024,1430,365,1253
4511,text,569,1233,32,20,22_denoise.png,1024,1430,601,1253
4512,text,607,1239,22,14,22_denoise.png,1024,1430,629,1253
4513,text,626,1232,238,24,22_denoise.png,1024,1430,864,1256
4514,text,87,1251,169,26,22_denoise.png,1024,1430,256,1277
4515,text,568,1252,188,24,22_denoise.png,1024,1430,756,1276
4516,text,762,1252,120,24,22_denoise.png,1024,1430,882,1276
4517,text,569,1275,28,18,22_denoise.png,1024,1430,597,1293
4518,text,607,1275,88,18,22_denoise.png,1024,1430,695,1293
4519,text,702,1272,126,24,22_denoise.png,1024,1430,828,1296
4520,text,566,1292,182,24,22_denoise.png,1024,1430,748,1316
4521,text,89,1359,718,21,22_denoise.png,1024,1430,807,1380
4522,text,848,518,20,18,22_denoise.png,1024,1430,868,536
4523,text,846,309,25,16,22_denoise.png,1024,1430,871,325
4524,text,679,99,130,18,22_median.png,1024,1430,809,117
4525,text,679,119,90,16,22_median.png,1024,1430,769,135
4526,text,773,119,100,16,22_median.png,1024,1430,873,135
4527,text,202,138,74,24,22_median.png,1024,1430,276,162
4528,text,428,136,118,24,22_median.png,1024,1430,546,160
4529,text,679,139,114,16,22_median.png,1024,1430,793,155
4530,text,460,156,55,20,22_median.png,1024,1430,515,176
4531,text,679,159,62,16,22_median.png,1024,1430,741,175
4532,text,749,159,118,16,22_median.png,1024,1430,867,175
4533,text,873,159,42,16,22_median.png,1024,1430,915,175
4534,text,81,263,270,21,22_median.png,1024,1430,351,284
4535,text,123,289,66,16,22_median.png,1024,1430,189,305
4536,text,241,289,112,16,22_median.png,1024,1430,353,305
4537,text,411,287,54,16,22_median.png,1024,1430,465,303
4538,text,559,289,64,16,22_median.png,1024,1430,623,305
4539,text,117,311,78,16,22_median.png,1024,1430,195,327
4540,text,261,311,70,16,22_median.png,1024,1430,331,327
4541,text,413,311,48,16,22_median.png,1024,1430,461,327
4542,text,559,305,207,20,22_median.png,1024,1430,766,325
4543,text,771,308,70,17,22_median.png,1024,1430,841,325
4544,text,557,325,96,20,22_median.png,1024,1430,653,345
4545,text,95,337,308,16,22_median.png,1024,1430,403,353
4546,text,95,355,62,16,22_median.png,1024,1430,157,371
4547,text,165,355,118,16,22_median.png,1024,1430,283,371
4548,text,289,357,42,14,22_median.png,1024,1430,331,371
4549,text,93,372,183,24,22_median.png,1024,1430,276,396
4550,text,93,393,220,20,22_median.png,1024,1430,313,413
4551,text,93,478,154,18,22_median.png,1024,1430,247,496
4552,text,557,479,218,16,22_median.png,1024,1430,775,495
4553,text,91,499,150,16,22_median.png,1024,1430,241,515
4554,text,249,499,54,16,22_median.png,1024,1430,303,515
4555,text,311,497,70,18,22_median.png,1024,1430,381,515
4556,text,557,499,64,16,22_median.png,1024,1430,621,515
4557,text,91,519,64,16,22_median.png,1024,1430,155,535
4558,text,557,519,207,16,22_median.png,1024,1430,764,535
4559,text,767,517,72,18,22_median.png,1024,1430,839,535
4560,text,89,535,40,20,22_median.png,1024,1430,129,555
4561,text,557,539,92,16,22_median.png,1024,1430,649,555
4562,text,89,555,84,20,22_median.png,1024,1430,173,575
4563,text,557,559,170,16,22_median.png,1024,1430,727,575
4564,text,91,579,166,18,22_median.png,1024,1430,257,597
4565,text,553,577,28,18,22_median.png,1024,1430,581,595
4566,text,602,578,114,16,22_median.png,1024,1430,716,594
4567,text,314,636,284,26,22_median.png,1024,1430,598,662
4568,text,855,645,62,16,22_median.png,1024,1430,917,661
4569,text,245,671,112,16,22_median.png,1024,1430,357,687
4570,text,543,671,52,14,22_median.png,1024,1430,595,685
4571,text,633,671,36,14,22_median.png,1024,1430,669,685
4572,text,703,671,74,16,22_median.png,1024,1430,777,687
4573,text,823,671,74,16,22_median.png,1024,1430,897,687
4574,text,89,693,224,18,22_median.png,1024,1430,313,711
4575,text,89,717,232,16,22_median.png,1024,1430,321,733
4576,text,89,739,148,16,22_median.png,1024,1430,237,755
4577,text,559,739,46,16,22_median.png,1024,1430,605,755
4578,text,629,739,42,18,22_median.png,1024,1430,671,757
4579,text,739,741,44,16,22_median.png,1024,1430,783,757
4580,text,859,741,56,16,22_median.png,1024,1430,915,757
4581,text,537,955,116,16,22_median.png,1024,1430,653,971
4582,text,787,953,88,18,22_median.png,1024,1430,875,971
4583,text,89,993,154,20,22_median.png,1024,1430,243,1013
4584,text,387,995,90,16,22_median.png,1024,1430,477,1011
4585,text,535,995,98,16,22_median.png,1024,1430,633,1011
4586,text,779,995,96,16,22_median.png,1024,1430,875,1011
4587,text,87,1039,106,16,22_median.png,1024,1430,193,1055
4588,text,215,1035,330,18,22_median.png,1024,1430,545,1053
4589,text,553,1037,184,18,22_median.png,1024,1430,737,1055
4590,text,90,1232,144,24,22_median.png,1024,1430,234,1256
4591,text,245,1233,120,20,22_median.png,1024,1430,365,1253
4592,text,569,1233,32,20,22_median.png,1024,1430,601,1253
4593,text,607,1239,22,14,22_median.png,1024,1430,629,1253
4594,text,626,1232,238,24,22_median.png,1024,1430,864,1256
4595,text,87,1251,169,26,22_median.png,1024,1430,256,1277
4596,text,568,1252,188,24,22_median.png,1024,1430,756,1276
4597,text,762,1252,120,24,22_median.png,1024,1430,882,1276
4598,text,569,1275,28,18,22_median.png,1024,1430,597,1293
4599,text,607,1275,88,18,22_median.png,1024,1430,695,1293
4600,text,702,1272,126,24,22_median.png,1024,1430,828,1296
4601,text,566,1292,182,24,22_median.png,1024,1430,748,1316
4602,text,89,1359,718,21,22_median.png,1024,1430,807,1380
4603,text,848,518,20,18,22_median.png,1024,1430,868,536
4604,text,846,309,25,16,22_median.png,1024,1430,871,325
4605,text,548,180,122,26,24.png,1024,1448,670,206
4606,text,399,238,79,28,24.png,1024,1448,478,266
4607,text,484,240,82,24,24.png,1024,1448,566,264
4608,text,574,240,88,24,24.png,1024,1448,662,264
4609,text,640,314,218,24,24.png,1024,1448,858,338
4610,text,326,398,56,24,24.png,1024,1448,382,422
4611,text,388,398,318,24,24.png,1024,1448,706,422
4612,text,427,467,198,20,24.png,1024,1448,625,487
4613,text,310,508,106,24,24.png,1024,1448,416,532
4614,text,611,509,38,20,24.png,1024,1448,649,529
4615,text,668,506,90,24,24.png,1024,1448,758,530
4616,text,780,506,112,24,24.png,1024,1448,892,530
4617,text,198,558,344,28,24.png,1024,1448,542,586
4618,text,674,558,80,24,24.png,1024,1448,754,582
4619,text,796,558,78,26,24.png,1024,1448,874,584
4620,text,195,582,239,28,24.png,1024,1448,434,610
4621,text,653,965,104,20,24.png,1024,1448,757,985
4622,text,794,962,74,24,24.png,1024,1448,868,986
4623,text,674,988,84,24,24.png,1024,1448,758,1012
4624,text,800,988,64,24,24.png,1024,1448,864,1012
4625,text,644,1014,114,24,24.png,1024,1448,758,1038
4626,text,792,1014,74,24,24.png,1024,1448,866,1038
4627,text,310,1081,414,25,24.png,1024,1448,724,1106
4628,text,384,1106,272,26,24.png,1024,1448,656,1132
4629,text,682,1184,86,26,24.png,1024,1448,768,1210
4630,text,234,1332,152,24,24.png,1024,1448,386,1356
4631,text,395,1332,182,21,24.png,1024,1448,577,1353
4632,text,584,1331,100,26,24.png,1024,1448,684,1357
4633,text,695,1333,98,20,24.png,1024,1448,793,1353
4634,text,171,1355,98,20,24.png,1024,1448,269,1375
4635,text,276,1352,151,23,24.png,1024,1448,427,1375
4636,text,681,1353,180,20,24.png,1024,1448,861,1373
4637,text,320,1375,184,20,24.png,1024,1448,504,1395
4638,text,523,1375,186,20,24.png,1024,1448,709,1395
4639,text,395,1396,245,24,24.png,1024,1448,640,1420
4640,text,619,557,18,27,24.png,1024,1448,637,584
4641,text,436,1355,97,19,24.png,1024,1448,533,1374
4642,text,540,1357,128,15,24.png,1024,1448,668,1372
4643,text,548,180,122,26,24_contrasted.png,1024,1448,670,206
4644,text,399,238,79,28,24_contrasted.png,1024,1448,478,266
4645,text,484,240,82,24,24_contrasted.png,1024,1448,566,264
4646,text,574,240,88,24,24_contrasted.png,1024,1448,662,264
4647,text,640,314,218,24,24_contrasted.png,1024,1448,858,338
4648,text,326,398,56,24,24_contrasted.png,1024,1448,382,422
4649,text,388,398,318,24,24_contrasted.png,1024,1448,706,422
4650,text,427,467,198,20,24_contrasted.png,1024,1448,625,487
4651,text,310,508,106,24,24_contrasted.png,1024,1448,416,532
4652,text,611,509,38,20,24_contrasted.png,1024,1448,649,529
4653,text,668,506,90,24,24_contrasted.png,1024,1448,758,530
4654,text,780,506,112,24,24_contrasted.png,1024,1448,892,530
4655,text,198,558,344,28,24_contrasted.png,1024,1448,542,586
4656,text,674,558,80,24,24_contrasted.png,1024,1448,754,582
4657,text,796,558,78,26,24_contrasted.png,1024,1448,874,584
4658,text,195,582,239,28,24_contrasted.png,1024,1448,434,610
4659,text,653,965,104,20,24_contrasted.png,1024,1448,757,985
4660,text,794,962,74,24,24_contrasted.png,1024,1448,868,986
4661,text,674,988,84,24,24_contrasted.png,1024,1448,758,1012
4662,text,800,988,64,24,24_contrasted.png,1024,1448,864,1012
4663,text,644,1014,114,24,24_contrasted.png,1024,1448,758,1038
4664,text,792,1014,74,24,24_contrasted.png,1024,1448,866,1038
4665,text,310,1081,414,25,24_contrasted.png,1024,1448,724,1106
4666,text,384,1106,272,26,24_contrasted.png,1024,1448,656,1132
4667,text,682,1184,86,26,24_contrasted.png,1024,1448,768,1210
4668,text,234,1332,152,24,24_contrasted.png,1024,1448,386,1356
4669,text,395,1332,182,21,24_contrasted.png,1024,1448,577,1353
4670,text,584,1331,100,26,24_contrasted.png,1024,1448,684,1357
4671,text,695,1333,98,20,24_contrasted.png,1024,1448,793,1353
4672,text,171,1355,98,20,24_contrasted.png,1024,1448,269,1375
4673,text,276,1352,151,23,24_contrasted.png,1024,1448,427,1375
4674,text,681,1353,180,20,24_contrasted.png,1024,1448,861,1373
4675,text,320,1375,184,20,24_contrasted.png,1024,1448,504,1395
4676,text,523,1375,186,20,24_contrasted.png,1024,1448,709,1395
4677,text,395,1396,245,24,24_contrasted.png,1024,1448,640,1420
4678,text,619,557,18,27,24_contrasted.png,1024,1448,637,584
4679,text,436,1355,97,19,24_contrasted.png,1024,1448,533,1374
4680,text,540,1357,128,15,24_contrasted.png,1024,1448,668,1372
4681,text,548,180,122,26,24_denoise.png,1024,1448,670,206
4682,text,399,238,79,28,24_denoise.png,1024,1448,478,266
4683,text,484,240,82,24,24_denoise.png,1024,1448,566,264
4684,text,574,240,88,24,24_denoise.png,1024,1448,662,264
4685,text,640,314,218,24,24_denoise.png,1024,1448,858,338
4686,text,326,398,56,24,24_denoise.png,1024,1448,382,422
4687,text,388,398,318,24,24_denoise.png,1024,1448,706,422
4688,text,427,467,198,20,24_denoise.png,1024,1448,625,487
4689,text,310,508,106,24,24_denoise.png,1024,1448,416,532
4690,text,611,509,38,20,24_denoise.png,1024,1448,649,529
4691,text,668,506,90,24,24_denoise.png,1024,1448,758,530
4692,text,780,506,112,24,24_denoise.png,1024,1448,892,530
4693,text,198,558,344,28,24_denoise.png,1024,1448,542,586
4694,text,674,558,80,24,24_denoise.png,1024,1448,754,582
4695,text,796,558,78,26,24_denoise.png,1024,1448,874,584
4696,text,195,582,239,28,24_denoise.png,1024,1448,434,610
4697,text,653,965,104,20,24_denoise.png,1024,1448,757,985
4698,text,794,962,74,24,24_denoise.png,1024,1448,868,986
4699,text,674,988,84,24,24_denoise.png,1024,1448,758,1012
4700,text,800,988,64,24,24_denoise.png,1024,1448,864,1012
4701,text,644,1014,114,24,24_denoise.png,1024,1448,758,1038
4702,text,792,1014,74,24,24_denoise.png,1024,1448,866,1038
4703,text,310,1081,414,25,24_denoise.png,1024,1448,724,1106
4704,text,384,1106,272,26,24_denoise.png,1024,1448,656,1132
4705,text,682,1184,86,26,24_denoise.png,1024,1448,768,1210
4706,text,234,1332,152,24,24_denoise.png,1024,1448,386,1356
4707,text,395,1332,182,21,24_denoise.png,1024,1448,577,1353
4708,text,584,1331,100,26,24_denoise.png,1024,1448,684,1357
4709,text,695,1333,98,20,24_denoise.png,1024,1448,793,1353
4710,text,171,1355,98,20,24_denoise.png,1024,1448,269,1375
4711,text,276,1352,151,23,24_denoise.png,1024,1448,427,1375
4712,text,681,1353,180,20,24_denoise.png,1024,1448,861,1373
4713,text,320,1375,184,20,24_denoise.png,1024,1448,504,1395
4714,text,523,1375,186,20,24_denoise.png,1024,1448,709,1395
4715,text,395,1396,245,24,24_denoise.png,1024,1448,640,1420
4716,text,619,557,18,27,24_denoise.png,1024,1448,637,584
4717,text,436,1355,97,19,24_denoise.png,1024,1448,533,1374
4718,text,540,1357,128,15,24_denoise.png,1024,1448,668,1372
4719,text,548,180,122,26,24_median.png,1024,1448,670,206
4720,text,399,238,79,28,24_median.png,1024,1448,478,266
4721,text,484,240,82,24,24_median.png,1024,1448,566,264
4722,text,574,240,88,24,24_median.png,1024,1448,662,264
4723,text,640,314,218,24,24_median.png,1024,1448,858,338
4724,text,326,398,56,24,24_median.png,1024,1448,382,422
4725,text,388,398,318,24,24_median.png,1024,1448,706,422
4726,text,427,467,198,20,24_median.png,1024,1448,625,487
4727,text,310,508,106,24,24_median.png,1024,1448,416,532
4728,text,611,509,38,20,24_median.png,1024,1448,649,529
4729,text,668,506,90,24,24_median.png,1024,1448,758,530
4730,text,780,506,112,24,24_median.png,1024,1448,892,530
4731,text,198,558,344,28,24_median.png,1024,1448,542,586
4732,text,674,558,80,24,24_median.png,1024,1448,754,582
4733,text,796,558,78,26,24_median.png,1024,1448,874,584
4734,text,195,582,239,28,24_median.png,1024,1448,434,610
4735,text,653,965,104,20,24_median.png,1024,1448,757,985
4736,text,794,962,74,24,24_median.png,1024,1448,868,986
4737,text,674,988,84,24,24_median.png,1024,1448,758,1012
4738,text,800,988,64,24,24_median.png,1024,1448,864,1012
4739,text,644,1014,114,24,24_median.png,1024,1448,758,1038
4740,text,792,1014,74,24,24_median.png,1024,1448,866,1038
4741,text,310,1081,414,25,24_median.png,1024,1448,724,1106
4742,text,384,1106,272,26,24_median.png,1024,1448,656,1132
4743,text,682,1184,86,26,24_median.png,1024,1448,768,1210
4744,text,234,1332,152,24,24_median.png,1024,1448,386,1356
4745,text,395,1332,182,21,24_median.png,1024,1448,577,1353
4746,text,584,1331,100,26,24_median.png,1024,1448,684,1357
4747,text,695,1333,98,20,24_median.png,1024,1448,793,1353
4748,text,171,1355,98,20,24_median.png,1024,1448,269,1375
4749,text,276,1352,151,23,24_median.png,1024,1448,427,1375
4750,text,681,1353,180,20,24_median.png,1024,1448,861,1373
4751,text,320,1375,184,20,24_median.png,1024,1448,504,1395
4752,text,523,1375,186,20,24_median.png,1024,1448,709,1395
4753,text,395,1396,245,24,24_median.png,1024,1448,640,1420
4754,text,619,557,18,27,24_median.png,1024,1448,637,584
4755,text,436,1355,97,19,24_median.png,1024,1448,533,1374
4756,text,540,1357,128,15,24_median.png,1024,1448,668,1372
4757,text,748,86,118,30,25.png,1024,1448,866,116
4758,text,109,131,234,36,25.png,1024,1448,343,167
4759,text,750,128,116,26,25.png,1024,1448,866,154
4760,text,99,185,92,18,25.png,1024,1448,191,203
4761,text,99,205,52,14,25.png,1024,1448,151,219
4762,text,99,221,22,16,25.png,1024,1448,121,237
4763,text,129,219,124,16,25.png,1024,1448,253,235
4764,text,97,241,36,16,25.png,1024,1448,133,257
4765,text,141,241,116,16,25.png,1024,1448,257,257
4766,text,102,264,82,24,25.png,1024,1448,184,288
4767,text,367,263,84,20,25.png,1024,1448,451,283
4768,text,646,260,102,20,25.png,1024,1448,748,280
4769,text,760,262,124,18,25.png,1024,1448,884,280
4770,text,105,297,98,16,25.png,1024,1448,203,313
4771,text,228,292,67,20,25.png,1024,1448,295,312
4772,text,361,297,76,18,25.png,1024,1448,437,315
4773,text,643,297,76,18,25.png,1024,1448,719,315
4774,text,103,321,74,16,25.png,1024,1448,177,337
4775,text,363,337,186,18,25.png,1024,1448,549,355
4776,text,645,337,188,16,25.png,1024,1448,833,353
4777,text,361,379,42,16,25.png,1024,1448,403,395
4778,text,427,377,42,18,25.png,1024,1448,469,395
4779,text,643,379,44,16,25.png,1024,1448,687,395
4780,text,709,377,44,18,25.png,1024,1448,753,395
4781,text,203,427,102,20,25.png,1024,1448,305,447
4782,text,612,426,58,24,25.png,1024,1448,670,450
4783,text,819,427,78,20,25.png,1024,1448,897,447
4784,text,141,473,32,14,25.png,1024,1448,173,487
4785,text,205,471,258,16,25.png,1024,1448,463,487
4786,text,485,473,52,14,25.png,1024,1448,537,487
4787,text,551,471,52,16,25.png,1024,1448,603,487
4788,text,629,471,118,16,25.png,1024,1448,747,487
4789,text,855,471,42,16,25.png,1024,1448,897,487
4790,text,141,505,38,14,25.png,1024,1448,179,519
4791,text,203,503,164,16,25.png,1024,1448,367,519
4792,text,485,505,50,16,25.png,1024,1448,535,521
4793,text,618,505,53,16,25.png,1024,1448,671,521
4794,text,679,503,28,16,25.png,1024,1448,707,519
4795,text,840,504,57,15,25.png,1024,1448,897,519
4796,text,355,1079,132,18,25.png,1024,1448,487,1097
4797,text,558,1085,107,18,25.png,1024,1448,665,1103
4798,text,673,1091,102,16,25.png,1024,1448,775,1107
4799,text,824,1089,63,20,25.png,1024,1448,887,1109
4800,text,299,1099,34,16,25.png,1024,1448,333,1115
4801,text,339,1099,52,16,25.png,1024,1448,391,1115
4802,text,407,1101,60,16,25.png,1024,1448,467,1117
4803,text,477,1101,66,16,25.png,1024,1448,543,1117
4804,text,577,1103,70,14,25.png,1024,1448,647,1117
4805,text,569,1125,80,18,25.png,1024,1448,649,1143
4806,text,673,1133,68,16,25.png,1024,1448,741,1149
4807,text,835,1131,50,20,25.png,1024,1448,885,1151
4808,text,673,1179,100,18,25.png,1024,1448,773,1197
4809,text,820,1181,65,20,25.png,1024,1448,885,1201
4810,text,568,1195,79,19,25.png,1024,1448,647,1214
4811,text,63,1249,170,20,25.png,1024,1448,233,1269
4812,text,387,1255,28,16,25.png,1024,1448,415,1271
4813,text,431,1255,76,16,25.png,1024,1448,507,1271
4814,text,697,1257,52,16,25.png,1024,1448,749,1273
4815,text,757,1255,70,20,25.png,1024,1448,827,1275
4816,text,59,1263,44,20,25.png,1024,1448,103,1283
4817,text,385,1271,24,16,25.png,1024,1448,409,1287
4818,text,429,1269,96,20,25.png,1024,1448,525,1289
4819,text,693,1271,46,20,25.png,1024,1448,739,1291
4820,text,759,1273,60,18,25.png,1024,1448,819,1291
4821,text,59,1287,132,16,25.png,1024,1448,191,1303
4822,text,383,1289,28,16,25.png,1024,1448,411,1305
4823,text,427,1287,98,20,25.png,1024,1448,525,1307
4824,text,763,1291,70,20,25.png,1024,1448,833,1311
4825,text,59,1303,132,18,25.png,1024,1448,191,1321
4826,text,365,1305,48,18,25.png,1024,1448,413,1323
4827,text,427,1305,96,18,25.png,1024,1448,523,1323
4828,text,693,1307,26,18,25.png,1024,1448,719,1325
4829,text,759,1309,46,18,25.png,1024,1448,805,1327
4830,text,59,1321,108,18,25.png,1024,1448,167,1339
4831,text,365,1323,36,16,25.png,1024,1448,401,1339
4832,text,427,1321,96,20,25.png,1024,1448,523,1341
4833,text,691,1325,30,18,25.png,1024,1448,721,1343
4834,text,755,1323,129,25,25.png,1024,1448,884,1348
4835,text,630,1394,230,26,25.png,1024,1448,860,1420
4836,text,103,1268,51,21,25.png,1024,1448,154,1289
4837,text,782,1373,77,21,25.png,1024,1448,859,1394
4838,text,97,428,36,24,25.png,1024,1448,133,452
4839,text,138,427,40,25,25.png,1024,1448,178,452
4840,text,495,426,30,24,25.png,1024,1448,525,450
4841,text,560,426,37,25,25.png,1024,1448,597,451
4842,text,758,426,45,25,25.png,1024,1448,803,451
4843,text,677,425,77,24,25.png,1024,1448,754,449
4844,text,201,484,25,18,25.png,1024,1448,226,502
4845,text,95,468,16,24,25.png,1024,1448,111,492
4846,text,91,500,20,26,25.png,1024,1448,111,526
4847,text,596,1170,30,17,25.png,1024,1448,626,1187
4848,text,688,1291,25,13,25.png,1024,1448,713,1304
4849,text,748,86,118,30,25_contrasted.png,1024,1448,866,116
4850,text,109,131,234,36,25_contrasted.png,1024,1448,343,167
4851,text,750,128,116,26,25_contrasted.png,1024,1448,866,154
4852,text,99,185,92,18,25_contrasted.png,1024,1448,191,203
4853,text,99,205,52,14,25_contrasted.png,1024,1448,151,219
4854,text,99,221,22,16,25_contrasted.png,1024,1448,121,237
4855,text,129,219,124,16,25_contrasted.png,1024,1448,253,235
4856,text,97,241,36,16,25_contrasted.png,1024,1448,133,257
4857,text,141,241,116,16,25_contrasted.png,1024,1448,257,257
4858,text,102,264,82,24,25_contrasted.png,1024,1448,184,288
4859,text,367,263,84,20,25_contrasted.png,1024,1448,451,283
4860,text,646,260,102,20,25_contrasted.png,1024,1448,748,280
4861,text,760,262,124,18,25_contrasted.png,1024,1448,884,280
4862,text,105,297,98,16,25_contrasted.png,1024,1448,203,313
4863,text,228,292,67,20,25_contrasted.png,1024,1448,295,312
4864,text,361,297,76,18,25_contrasted.png,1024,1448,437,315
4865,text,643,297,76,18,25_contrasted.png,1024,1448,719,315
4866,text,103,321,74,16,25_contrasted.png,1024,1448,177,337
4867,text,363,337,186,18,25_contrasted.png,1024,1448,549,355
4868,text,645,337,188,16,25_contrasted.png,1024,1448,833,353
4869,text,361,379,42,16,25_contrasted.png,1024,1448,403,395
4870,text,427,377,42,18,25_contrasted.png,1024,1448,469,395
4871,text,643,379,44,16,25_contrasted.png,1024,1448,687,395
4872,text,709,377,44,18,25_contrasted.png,1024,1448,753,395
4873,text,203,427,102,20,25_contrasted.png,1024,1448,305,447
4874,text,612,426,58,24,25_contrasted.png,1024,1448,670,450
4875,text,819,427,78,20,25_contrasted.png,1024,1448,897,447
4876,text,141,473,32,14,25_contrasted.png,1024,1448,173,487
4877,text,205,471,258,16,25_contrasted.png,1024,1448,463,487
4878,text,485,473,52,14,25_contrasted.png,1024,1448,537,487
4879,text,551,471,52,16,25_contrasted.png,1024,1448,603,487
4880,text,629,471,118,16,25_contrasted.png,1024,1448,747,487
4881,text,855,471,42,16,25_contrasted.png,1024,1448,897,487
4882,text,141,505,38,14,25_contrasted.png,1024,1448,179,519
4883,text,203,503,164,16,25_contrasted.png,1024,1448,367,519
4884,text,485,505,50,16,25_contrasted.png,1024,1448,535,521
4885,text,618,505,53,16,25_contrasted.png,1024,1448,671,521
4886,text,679,503,28,16,25_contrasted.png,1024,1448,707,519
4887,text,840,504,57,15,25_contrasted.png,1024,1448,897,519
4888,text,355,1079,132,18,25_contrasted.png,1024,1448,487,1097
4889,text,558,1085,107,18,25_contrasted.png,1024,1448,665,1103
4890,text,673,1091,102,16,25_contrasted.png,1024,1448,775,1107
4891,text,824,1089,63,20,25_contrasted.png,1024,1448,887,1109
4892,text,299,1099,34,16,25_contrasted.png,1024,1448,333,1115
4893,text,339,1099,52,16,25_contrasted.png,1024,1448,391,1115
4894,text,407,1101,60,16,25_contrasted.png,1024,1448,467,1117
4895,text,477,1101,66,16,25_contrasted.png,1024,1448,543,1117
4896,text,577,1103,70,14,25_contrasted.png,1024,1448,647,1117
4897,text,569,1125,80,18,25_contrasted.png,1024,1448,649,1143
4898,text,673,1133,68,16,25_contrasted.png,1024,1448,741,1149
4899,text,835,1131,50,20,25_contrasted.png,1024,1448,885,1151
4900,text,673,1179,100,18,25_contrasted.png,1024,1448,773,1197
4901,text,820,1181,65,20,25_contrasted.png,1024,1448,885,1201
4902,text,568,1195,79,19,25_contrasted.png,1024,1448,647,1214
4903,text,63,1249,170,20,25_contrasted.png,1024,1448,233,1269
4904,text,387,1255,28,16,25_contrasted.png,1024,1448,415,1271
4905,text,431,1255,76,16,25_contrasted.png,1024,1448,507,1271
4906,text,697,1257,52,16,25_contrasted.png,1024,1448,749,1273
4907,text,757,1255,70,20,25_contrasted.png,1024,1448,827,1275
4908,text,59,1263,44,20,25_contrasted.png,1024,1448,103,1283
4909,text,385,1271,24,16,25_contrasted.png,1024,1448,409,1287
4910,text,429,1269,96,20,25_contrasted.png,1024,1448,525,1289
4911,text,693,1271,46,20,25_contrasted.png,1024,1448,739,1291
4912,text,759,1273,60,18,25_contrasted.png,1024,1448,819,1291
4913,text,59,1287,132,16,25_contrasted.png,1024,1448,191,1303
4914,text,383,1289,28,16,25_contrasted.png,1024,1448,411,1305
4915,text,427,1287,98,20,25_contrasted.png,1024,1448,525,1307
4916,text,763,1291,70,20,25_contrasted.png,1024,1448,833,1311
4917,text,59,1303,132,18,25_contrasted.png,1024,1448,191,1321
4918,text,365,1305,48,18,25_contrasted.png,1024,1448,413,1323
4919,text,427,1305,96,18,25_contrasted.png,1024,1448,523,1323
4920,text,693,1307,26,18,25_contrasted.png,1024,1448,719,1325
4921,text,759,1309,46,18,25_contrasted.png,1024,1448,805,1327
4922,text,59,1321,108,18,25_contrasted.png,1024,1448,167,1339
4923,text,365,1323,36,16,25_contrasted.png,1024,1448,401,1339
4924,text,427,1321,96,20,25_contrasted.png,1024,1448,523,1341
4925,text,691,1325,30,18,25_contrasted.png,1024,1448,721,1343
4926,text,755,1323,129,25,25_contrasted.png,1024,1448,884,1348
4927,text,630,1394,230,26,25_contrasted.png,1024,1448,860,1420
4928,text,103,1268,51,21,25_contrasted.png,1024,1448,154,1289
4929,text,782,1373,77,21,25_contrasted.png,1024,1448,859,1394
4930,text,97,428,36,24,25_contrasted.png,1024,1448,133,452
4931,text,138,427,40,25,25_contrasted.png,1024,1448,178,452
4932,text,495,426,30,24,25_contrasted.png,1024,1448,525,450
4933,text,560,426,37,25,25_contrasted.png,1024,1448,597,451
4934,text,758,426,45,25,25_contrasted.png,1024,1448,803,451
4935,text,677,425,77,24,25_contrasted.png,1024,1448,754,449
4936,text,201,484,25,18,25_contrasted.png,1024,1448,226,502
4937,text,95,468,16,24,25_contrasted.png,1024,1448,111,492
4938,text,91,500,20,26,25_contrasted.png,1024,1448,111,526
4939,text,596,1170,30,17,25_contrasted.png,1024,1448,626,1187
4940,text,688,1291,25,13,25_contrasted.png,1024,1448,713,1304
4941,text,748,86,118,30,25_denoise.png,1024,1448,866,116
4942,text,109,131,234,36,25_denoise.png,1024,1448,343,167
4943,text,750,128,116,26,25_denoise.png,1024,1448,866,154
4944,text,99,185,92,18,25_denoise.png,1024,1448,191,203
4945,text,99,205,52,14,25_denoise.png,1024,1448,151,219
4946,text,99,221,22,16,25_denoise.png,1024,1448,121,237
4947,text,129,219,124,16,25_denoise.png,1024,1448,253,235
4948,text,97,241,36,16,25_denoise.png,1024,1448,133,257
4949,text,141,241,116,16,25_denoise.png,1024,1448,257,257
4950,text,102,264,82,24,25_denoise.png,1024,1448,184,288
4951,text,367,263,84,20,25_denoise.png,1024,1448,451,283
4952,text,646,260,102,20,25_denoise.png,1024,1448,748,280
4953,text,760,262,124,18,25_denoise.png,1024,1448,884,280
4954,text,105,297,98,16,25_denoise.png,1024,1448,203,313
4955,text,228,292,67,20,25_denoise.png,1024,1448,295,312
4956,text,361,297,76,18,25_denoise.png,1024,1448,437,315
4957,text,643,297,76,18,25_denoise.png,1024,1448,719,315
4958,text,103,321,74,16,25_denoise.png,1024,1448,177,337
4959,text,363,337,186,18,25_denoise.png,1024,1448,549,355
4960,text,645,337,188,16,25_denoise.png,1024,1448,833,353
4961,text,361,379,42,16,25_denoise.png,1024,1448,403,395
4962,text,427,377,42,18,25_denoise.png,1024,1448,469,395
4963,text,643,379,44,16,25_denoise.png,1024,1448,687,395
4964,text,709,377,44,18,25_denoise.png,1024,1448,753,395
4965,text,203,427,102,20,25_denoise.png,1024,1448,305,447
4966,text,612,426,58,24,25_denoise.png,1024,1448,670,450
4967,text,819,427,78,20,25_denoise.png,1024,1448,897,447
4968,text,141,473,32,14,25_denoise.png,1024,1448,173,487
4969,text,205,471,258,16,25_denoise.png,1024,1448,463,487
4970,text,485,473,52,14,25_denoise.png,1024,1448,537,487
4971,text,551,471,52,16,25_denoise.png,1024,1448,603,487
4972,text,629,471,118,16,25_denoise.png,1024,1448,747,487
4973,text,855,471,42,16,25_denoise.png,1024,1448,897,487
4974,text,141,505,38,14,25_denoise.png,1024,1448,179,519
4975,text,203,503,164,16,25_denoise.png,1024,1448,367,519
4976,text,485,505,50,16,25_denoise.png,1024,1448,535,521
4977,text,618,505,53,16,25_denoise.png,1024,1448,671,521
4978,text,679,503,28,16,25_denoise.png,1024,1448,707,519
4979,text,840,504,57,15,25_denoise.png,1024,1448,897,519
4980,text,355,1079,132,18,25_denoise.png,1024,1448,487,1097
4981,text,558,1085,107,18,25_denoise.png,1024,1448,665,1103
4982,text,673,1091,102,16,25_denoise.png,1024,1448,775,1107
4983,text,824,1089,63,20,25_denoise.png,1024,1448,887,1109
4984,text,299,1099,34,16,25_denoise.png,1024,1448,333,1115
4985,text,339,1099,52,16,25_denoise.png,1024,1448,391,1115
4986,text,407,1101,60,16,25_denoise.png,1024,1448,467,1117
4987,text,477,1101,66,16,25_denoise.png,1024,1448,543,1117
4988,text,577,1103,70,14,25_denoise.png,1024,1448,647,1117
4989,text,569,1125,80,18,25_denoise.png,1024,1448,649,1143
4990,text,673,1133,68,16,25_denoise.png,1024,1448,741,1149
4991,text,835,1131,50,20,25_denoise.png,1024,1448,885,1151
4992,text,673,1179,100,18,25_denoise.png,1024,1448,773,1197
4993,text,820,1181,65,20,25_denoise.png,1024,1448,885,1201
4994,text,568,1195,79,19,25_denoise.png,1024,1448,647,1214
4995,text,63,1249,170,20,25_denoise.png,1024,1448,233,1269
4996,text,387,1255,28,16,25_denoise.png,1024,1448,415,1271
4997,text,431,1255,76,16,25_denoise.png,1024,1448,507,1271
4998,text,697,1257,52,16,25_denoise.png,1024,1448,749,1273
4999,text,757,1255,70,20,25_denoise.png,1024,1448,827,1275
5000,text,59,1263,44,20,25_denoise.png,1024,1448,103,1283
5001,text,385,1271,24,16,25_denoise.png,1024,1448,409,1287
5002,text,429,1269,96,20,25_denoise.png,1024,1448,525,1289
5003,text,693,1271,46,20,25_denoise.png,1024,1448,739,1291
5004,text,759,1273,60,18,25_denoise.png,1024,1448,819,1291
5005,text,59,1287,132,16,25_denoise.png,1024,1448,191,1303
5006,text,383,1289,28,16,25_denoise.png,1024,1448,411,1305
5007,text,427,1287,98,20,25_denoise.png,1024,1448,525,1307
5008,text,763,1291,70,20,25_denoise.png,1024,1448,833,1311
5009,text,59,1303,132,18,25_denoise.png,1024,1448,191,1321
5010,text,365,1305,48,18,25_denoise.png,1024,1448,413,1323
5011,text,427,1305,96,18,25_denoise.png,1024,1448,523,1323
5012,text,693,1307,26,18,25_denoise.png,1024,1448,719,1325
5013,text,759,1309,46,18,25_denoise.png,1024,1448,805,1327
5014,text,59,1321,108,18,25_denoise.png,1024,1448,167,1339
5015,text,365,1323,36,16,25_denoise.png,1024,1448,401,1339
5016,text,427,1321,96,20,25_denoise.png,1024,1448,523,1341
5017,text,691,1325,30,18,25_denoise.png,1024,1448,721,1343
5018,text,755,1323,129,25,25_denoise.png,1024,1448,884,1348
5019,text,630,1394,230,26,25_denoise.png,1024,1448,860,1420
5020,text,103,1268,51,21,25_denoise.png,1024,1448,154,1289
5021,text,782,1373,77,21,25_denoise.png,1024,1448,859,1394
5022,text,97,428,36,24,25_denoise.png,1024,1448,133,452
5023,text,138,427,40,25,25_denoise.png,1024,1448,178,452
5024,text,495,426,30,24,25_denoise.png,1024,1448,525,450
5025,text,560,426,37,25,25_denoise.png,1024,1448,597,451
5026,text,758,426,45,25,25_denoise.png,1024,1448,803,451
5027,text,677,425,77,24,25_denoise.png,1024,1448,754,449
5028,text,201,484,25,18,25_denoise.png,1024,1448,226,502
5029,text,95,468,16,24,25_denoise.png,1024,1448,111,492
5030,text,91,500,20,26,25_denoise.png,1024,1448,111,526
5031,text,596,1170,30,17,25_denoise.png,1024,1448,626,1187
5032,text,688,1291,25,13,25_denoise.png,1024,1448,713,1304
5033,text,748,86,118,30,25_median.png,1024,1448,866,116
5034,text,109,131,234,36,25_median.png,1024,1448,343,167
5035,text,750,128,116,26,25_median.png,1024,1448,866,154
5036,text,99,185,92,18,25_median.png,1024,1448,191,203
5037,text,99,205,52,14,25_median.png,1024,1448,151,219
5038,text,99,221,22,16,25_median.png,1024,1448,121,237
5039,text,129,219,124,16,25_median.png,1024,1448,253,235
5040,text,97,241,36,16,25_median.png,1024,1448,133,257
5041,text,141,241,116,16,25_median.png,1024,1448,257,257
5042,text,102,264,82,24,25_median.png,1024,1448,184,288
5043,text,367,263,84,20,25_median.png,1024,1448,451,283
5044,text,646,260,102,20,25_median.png,1024,1448,748,280
5045,text,760,262,124,18,25_median.png,1024,1448,884,280
5046,text,105,297,98,16,25_median.png,1024,1448,203,313
5047,text,228,292,67,20,25_median.png,1024,1448,295,312
5048,text,361,297,76,18,25_median.png,1024,1448,437,315
5049,text,643,297,76,18,25_median.png,1024,1448,719,315
5050,text,103,321,74,16,25_median.png,1024,1448,177,337
5051,text,363,337,186,18,25_median.png,1024,1448,549,355
5052,text,645,337,188,16,25_median.png,1024,1448,833,353
5053,text,361,379,42,16,25_median.png,1024,1448,403,395
5054,text,427,377,42,18,25_median.png,1024,1448,469,395
5055,text,643,379,44,16,25_median.png,1024,1448,687,395
5056,text,709,377,44,18,25_median.png,1024,1448,753,395
5057,text,203,427,102,20,25_median.png,1024,1448,305,447
5058,text,612,426,58,24,25_median.png,1024,1448,670,450
5059,text,819,427,78,20,25_median.png,1024,1448,897,447
5060,text,141,473,32,14,25_median.png,1024,1448,173,487
5061,text,205,471,258,16,25_median.png,1024,1448,463,487
5062,text,485,473,52,14,25_median.png,1024,1448,537,487
5063,text,551,471,52,16,25_median.png,1024,1448,603,487
5064,text,629,471,118,16,25_median.png,1024,1448,747,487
5065,text,855,471,42,16,25_median.png,1024,1448,897,487
5066,text,141,505,38,14,25_median.png,1024,1448,179,519
5067,text,203,503,164,16,25_median.png,1024,1448,367,519
5068,text,485,505,50,16,25_median.png,1024,1448,535,521
5069,text,618,505,53,16,25_median.png,1024,1448,671,521
5070,text,679,503,28,16,25_median.png,1024,1448,707,519
5071,text,840,504,57,15,25_median.png,1024,1448,897,519
5072,text,355,1079,132,18,25_median.png,1024,1448,487,1097
5073,text,558,1085,107,18,25_median.png,1024,1448,665,1103
5074,text,673,1091,102,16,25_median.png,1024,1448,775,1107
5075,text,824,1089,63,20,25_median.png,1024,1448,887,1109
5076,text,299,1099,34,16,25_median.png,1024,1448,333,1115
5077,text,339,1099,52,16,25_median.png,1024,1448,391,1115
5078,text,407,1101,60,16,25_median.png,1024,1448,467,1117
5079,text,477,1101,66,16,25_median.png,1024,1448,543,1117
5080,text,577,1103,70,14,25_median.png,1024,1448,647,1117
5081,text,569,1125,80,18,25_median.png,1024,1448,649,1143
5082,text,673,1133,68,16,25_median.png,1024,1448,741,1149
5083,text,835,1131,50,20,25_median.png,1024,1448,885,1151
5084,text,673,1179,100,18,25_median.png,1024,1448,773,1197
5085,text,820,1181,65,20,25_median.png,1024,1448,885,1201
5086,text,568,1195,79,19,25_median.png,1024,1448,647,1214
5087,text,63,1249,170,20,25_median.png,1024,1448,233,1269
5088,text,387,1255,28,16,25_median.png,1024,1448,415,1271
5089,text,431,1255,76,16,25_median.png,1024,1448,507,1271
5090,text,697,1257,52,16,25_median.png,1024,1448,749,1273
5091,text,757,1255,70,20,25_median.png,1024,1448,827,1275
5092,text,59,1263,44,20,25_median.png,1024,1448,103,1283
5093,text,385,1271,24,16,25_median.png,1024,1448,409,1287
5094,text,429,1269,96,20,25_median.png,1024,1448,525,1289
5095,text,693,1271,46,20,25_median.png,1024,1448,739,1291
5096,text,759,1273,60,18,25_median.png,1024,1448,819,1291
5097,text,59,1287,132,16,25_median.png,1024,1448,191,1303
5098,text,383,1289,28,16,25_median.png,1024,1448,411,1305
5099,text,427,1287,98,20,25_median.png,1024,1448,525,1307
5100,text,763,1291,70,20,25_median.png,1024,1448,833,1311
5101,text,59,1303,132,18,25_median.png,1024,1448,191,1321
5102,text,365,1305,48,18,25_median.png,1024,1448,413,1323
5103,text,427,1305,96,18,25_median.png,1024,1448,523,1323
5104,text,693,1307,26,18,25_median.png,1024,1448,719,1325
5105,text,759,1309,46,18,25_median.png,1024,1448,805,1327
5106,text,59,1321,108,18,25_median.png,1024,1448,167,1339
5107,text,365,1323,36,16,25_median.png,1024,1448,401,1339
5108,text,427,1321,96,20,25_median.png,1024,1448,523,1341
5109,text,691,1325,30,18,25_median.png,1024,1448,721,1343
5110,text,755,1323,129,25,25_median.png,1024,1448,884,1348
5111,text,630,1394,230,26,25_median.png,1024,1448,860,1420
5112,text,103,1268,51,21,25_median.png,1024,1448,154,1289
5113,text,782,1373,77,21,25_median.png,1024,1448,859,1394
5114,text,97,428,36,24,25_median.png,1024,1448,133,452
5115,text,138,427,40,25,25_median.png,1024,1448,178,452
5116,text,495,426,30,24,25_median.png,1024,1448,525,450
5117,text,560,426,37,25,25_median.png,1024,1448,597,451
5118,text,758,426,45,25,25_median.png,1024,1448,803,451
5119,text,677,425,77,24,25_median.png,1024,1448,754,449
5120,text,201,484,25,18,25_median.png,1024,1448,226,502
5121,text,95,468,16,24,25_median.png,1024,1448,111,492
5122,text,91,500,20,26,25_median.png,1024,1448,111,526
5123,text,596,1170,30,17,25_median.png,1024,1448,626,1187
5124,text,688,1291,25,13,25_median.png,1024,1448,713,1304
5125,text,48,72,166,32,26.png,1024,1448,214,104
5126,text,583,175,142,20,26.png,1024,1448,725,195
5127,text,118,200,144,26,26.png,1024,1448,262,226
5128,text,276,200,150,30,26.png,1024,1448,426,230
5129,text,580,210,196,24,26.png,1024,1448,776,234
5130,text,580,246,140,24,26.png,1024,1448,720,270
5131,text,723,322,243,26,26.png,1024,1448,966,348
5132,text,28,344,106,24,26.png,1024,1448,134,368
5133,text,192,346,74,24,26.png,1024,1448,266,370
5134,text,31,399,110,20,26.png,1024,1448,141,419
5135,text,267,397,111,29,26.png,1024,1448,378,426
5136,text,516,400,38,24,26.png,1024,1448,554,424
5137,text,601,403,42,20,26.png,1024,1448,643,423
5138,text,681,403,68,20,26.png,1024,1448,749,423
5139,text,787,403,80,20,26.png,1024,1448,867,423
5140,text,905,403,38,20,26.png,1024,1448,943,423
5141,text,180,430,288,24,26.png,1024,1448,468,454
5142,text,23,455,46,20,26.png,1024,1448,69,475
5143,text,148,456,230,24,26.png,1024,1448,378,480
5144,text,525,459,40,18,26.png,1024,1448,565,477
5145,text,617,459,60,18,26.png,1024,1448,677,477
5146,text,687,457,66,20,26.png,1024,1448,753,477
5147,text,824,454,134,26,26.png,1024,1448,958,480
5148,text,20,481,88,21,26.png,1024,1448,108,502
5149,text,149,483,312,20,26.png,1024,1448,461,503
5150,text,525,483,40,20,26.png,1024,1448,565,503
5151,text,617,483,60,20,26.png,1024,1448,677,503
5152,text,687,483,64,20,26.png,1024,1448,751,503
5153,text,824,482,134,24,26.png,1024,1448,958,506
5154,text,148,506,304,24,26.png,1024,1448,452,530
5155,text,523,509,40,20,26.png,1024,1448,563,529
5156,text,617,509,60,20,26.png,1024,1448,677,529
5157,text,685,509,68,20,26.png,1024,1448,753,529
5158,text,825,509,60,20,26.png,1024,1448,885,529
5159,text,899,509,58,20,26.png,1024,1448,957,529
5160,text,46,1152,72,24,26.png,1024,1448,118,1176
5161,text,159,1153,40,20,26.png,1024,1448,199,1173
5162,text,681,1153,100,20,26.png,1024,1448,781,1173
5163,text,878,1152,74,24,26.png,1024,1448,952,1176
5164,text,44,1180,74,24,26.png,1024,1448,118,1204
5165,text,151,1183,52,20,26.png,1024,1448,203,1203
5166,text,249,1183,60,20,26.png,1024,1448,309,1203
5167,text,671,1183,112,20,26.png,1024,1448,783,1203
5168,text,890,1182,62,24,26.png,1024,1448,952,1206
5169,text,878,1212,74,24,26.png,1024,1448,952,1236
5170,text,673,1213,114,20,26.png,1024,1448,787,1233
5171,text,14,1248,372,26,26.png,1024,1448,386,1274
5172,text,20,1275,459,25,26.png,1024,1448,479,1300
5173,text,20,1296,110,24,26.png,1024,1448,130,1320
5174,text,44,1354,372,24,26.png,1024,1448,416,1378
5175,text,423,1357,424,20,26.png,1024,1448,847,1377
5176,text,859,1357,38,18,26.png,1024,1448,897,1375
5177,text,171,1375,118,20,26.png,1024,1448,289,1395
5178,text,295,1375,154,20,26.png,1024,1448,449,1395
5179,text,455,1375,110,20,26.png,1024,1448,565,1395
5180,text,572,1375,208,20,26.png,1024,1448,780,1395
5181,text,59,505,22,27,26.png,1024,1448,81,532
5182,text,19,505,22,25,26.png,1024,1448,41,530
5183,text,48,72,166,32,26_contrasted.png,1024,1448,214,104
5184,text,583,175,142,20,26_contrasted.png,1024,1448,725,195
5185,text,118,200,144,26,26_contrasted.png,1024,1448,262,226
5186,text,276,200,150,30,26_contrasted.png,1024,1448,426,230
5187,text,580,210,196,24,26_contrasted.png,1024,1448,776,234
5188,text,580,246,140,24,26_contrasted.png,1024,1448,720,270
5189,text,723,322,243,26,26_contrasted.png,1024,1448,966,348
5190,text,28,344,106,24,26_contrasted.png,1024,1448,134,368
5191,text,192,346,74,24,26_contrasted.png,1024,1448,266,370
5192,text,31,399,110,20,26_contrasted.png,1024,1448,141,419
5193,text,267,397,111,29,26_contrasted.png,1024,1448,378,426
5194,text,516,400,38,24,26_contrasted.png,1024,1448,554,424
5195,text,601,403,42,20,26_contrasted.png,1024,1448,643,423
5196,text,681,403,68,20,26_contrasted.png,1024,1448,749,423
5197,text,787,403,80,20,26_contrasted.png,1024,1448,867,423
5198,text,905,403,38,20,26_contrasted.png,1024,1448,943,423
5199,text,180,430,288,24,26_contrasted.png,1024,1448,468,454
5200,text,23,455,46,20,26_contrasted.png,1024,1448,69,475
5201,text,148,456,230,24,26_contrasted.png,1024,1448,378,480
5202,text,525,459,40,18,26_contrasted.png,1024,1448,565,477
5203,text,617,459,60,18,26_contrasted.png,1024,1448,677,477
5204,text,687,457,66,20,26_contrasted.png,1024,1448,753,477
5205,text,824,454,134,26,26_contrasted.png,1024,1448,958,480
5206,text,20,481,88,21,26_contrasted.png,1024,1448,108,502
5207,text,149,483,312,20,26_contrasted.png,1024,1448,461,503
5208,text,525,483,40,20,26_contrasted.png,1024,1448,565,503
5209,text,617,483,60,20,26_contrasted.png,1024,1448,677,503
5210,text,687,483,64,20,26_contrasted.png,1024,1448,751,503
5211,text,824,482,134,24,26_contrasted.png,1024,1448,958,506
5212,text,148,506,304,24,26_contrasted.png,1024,1448,452,530
5213,text,523,509,40,20,26_contrasted.png,1024,1448,563,529
5214,text,617,509,60,20,26_contrasted.png,1024,1448,677,529
5215,text,685,509,68,20,26_contrasted.png,1024,1448,753,529
5216,text,825,509,60,20,26_contrasted.png,1024,1448,885,529
5217,text,899,509,58,20,26_contrasted.png,1024,1448,957,529
5218,text,46,1152,72,24,26_contrasted.png,1024,1448,118,1176
5219,text,159,1153,40,20,26_contrasted.png,1024,1448,199,1173
5220,text,681,1153,100,20,26_contrasted.png,1024,1448,781,1173
5221,text,878,1152,74,24,26_contrasted.png,1024,1448,952,1176
5222,text,44,1180,74,24,26_contrasted.png,1024,1448,118,1204
5223,text,151,1183,52,20,26_contrasted.png,1024,1448,203,1203
5224,text,249,1183,60,20,26_contrasted.png,1024,1448,309,1203
5225,text,671,1183,112,20,26_contrasted.png,1024,1448,783,1203
5226,text,890,1182,62,24,26_contrasted.png,1024,1448,952,1206
5227,text,878,1212,74,24,26_contrasted.png,1024,1448,952,1236
5228,text,673,1213,114,20,26_contrasted.png,1024,1448,787,1233
5229,text,14,1248,372,26,26_contrasted.png,1024,1448,386,1274
5230,text,20,1275,459,25,26_contrasted.png,1024,1448,479,1300
5231,text,20,1296,110,24,26_contrasted.png,1024,1448,130,1320
5232,text,44,1354,372,24,26_contrasted.png,1024,1448,416,1378
5233,text,423,1357,424,20,26_contrasted.png,1024,1448,847,1377
5234,text,859,1357,38,18,26_contrasted.png,1024,1448,897,1375
5235,text,171,1375,118,20,26_contrasted.png,1024,1448,289,1395
5236,text,295,1375,154,20,26_contrasted.png,1024,1448,449,1395
5237,text,455,1375,110,20,26_contrasted.png,1024,1448,565,1395
5238,text,572,1375,208,20,26_contrasted.png,1024,1448,780,1395
5239,text,59,505,22,27,26_contrasted.png,1024,1448,81,532
5240,text,19,505,22,25,26_contrasted.png,1024,1448,41,530
5241,text,48,72,166,32,26_denoise.png,1024,1448,214,104
5242,text,583,175,142,20,26_denoise.png,1024,1448,725,195
5243,text,118,200,144,26,26_denoise.png,1024,1448,262,226
5244,text,276,200,150,30,26_denoise.png,1024,1448,426,230
5245,text,580,210,196,24,26_denoise.png,1024,1448,776,234
5246,text,580,246,140,24,26_denoise.png,1024,1448,720,270
5247,text,723,322,243,26,26_denoise.png,1024,1448,966,348
5248,text,28,344,106,24,26_denoise.png,1024,1448,134,368
5249,text,192,346,74,24,26_denoise.png,1024,1448,266,370
5250,text,31,399,110,20,26_denoise.png,1024,1448,141,419
5251,text,267,397,111,29,26_denoise.png,1024,1448,378,426
5252,text,516,400,38,24,26_denoise.png,1024,1448,554,424
5253,text,601,403,42,20,26_denoise.png,1024,1448,643,423
5254,text,681,403,68,20,26_denoise.png,1024,1448,749,423
5255,text,787,403,80,20,26_denoise.png,1024,1448,867,423
5256,text,905,403,38,20,26_denoise.png,1024,1448,943,423
5257,text,180,430,288,24,26_denoise.png,1024,1448,468,454
5258,text,23,455,46,20,26_denoise.png,1024,1448,69,475
5259,text,148,456,230,24,26_denoise.png,1024,1448,378,480
5260,text,525,459,40,18,26_denoise.png,1024,1448,565,477
5261,text,617,459,60,18,26_denoise.png,1024,1448,677,477
5262,text,687,457,66,20,26_denoise.png,1024,1448,753,477
5263,text,824,454,134,26,26_denoise.png,1024,1448,958,480
5264,text,20,481,88,21,26_denoise.png,1024,1448,108,502
5265,text,149,483,312,20,26_denoise.png,1024,1448,461,503
5266,text,525,483,40,20,26_denoise.png,1024,1448,565,503
5267,text,617,483,60,20,26_denoise.png,1024,1448,677,503
5268,text,687,483,64,20,26_denoise.png,1024,1448,751,503
5269,text,824,482,134,24,26_denoise.png,1024,1448,958,506
5270,text,148,506,304,24,26_denoise.png,1024,1448,452,530
5271,text,523,509,40,20,26_denoise.png,1024,1448,563,529
5272,text,617,509,60,20,26_denoise.png,1024,1448,677,529
5273,text,685,509,68,20,26_denoise.png,1024,1448,753,529
5274,text,825,509,60,20,26_denoise.png,1024,1448,885,529
5275,text,899,509,58,20,26_denoise.png,1024,1448,957,529
5276,text,46,1152,72,24,26_denoise.png,1024,1448,118,1176
5277,text,159,1153,40,20,26_denoise.png,1024,1448,199,1173
5278,text,681,1153,100,20,26_denoise.png,1024,1448,781,1173
5279,text,878,1152,74,24,26_denoise.png,1024,1448,952,1176
5280,text,44,1180,74,24,26_denoise.png,1024,1448,118,1204
5281,text,151,1183,52,20,26_denoise.png,1024,1448,203,1203
5282,text,249,1183,60,20,26_denoise.png,1024,1448,309,1203
5283,text,671,1183,112,20,26_denoise.png,1024,1448,783,1203
5284,text,890,1182,62,24,26_denoise.png,1024,1448,952,1206
5285,text,878,1212,74,24,26_denoise.png,1024,1448,952,1236
5286,text,673,1213,114,20,26_denoise.png,1024,1448,787,1233
5287,text,14,1248,372,26,26_denoise.png,1024,1448,386,1274
5288,text,20,1275,459,25,26_denoise.png,1024,1448,479,1300
5289,text,20,1296,110,24,26_denoise.png,1024,1448,130,1320
5290,text,44,1354,372,24,26_denoise.png,1024,1448,416,1378
5291,text,423,1357,424,20,26_denoise.png,1024,1448,847,1377
5292,text,859,1357,38,18,26_denoise.png,1024,1448,897,1375
5293,text,171,1375,118,20,26_denoise.png,1024,1448,289,1395
5294,text,295,1375,154,20,26_denoise.png,1024,1448,449,1395
5295,text,455,1375,110,20,26_denoise.png,1024,1448,565,1395
5296,text,572,1375,208,20,26_denoise.png,1024,1448,780,1395
5297,text,59,505,22,27,26_denoise.png,1024,1448,81,532
5298,text,19,505,22,25,26_denoise.png,1024,1448,41,530
5299,text,48,72,166,32,26_median.png,1024,1448,214,104
5300,text,583,175,142,20,26_median.png,1024,1448,725,195
5301,text,118,200,144,26,26_median.png,1024,1448,262,226
5302,text,276,200,150,30,26_median.png,1024,1448,426,230
5303,text,580,210,196,24,26_median.png,1024,1448,776,234
5304,text,580,246,140,24,26_median.png,1024,1448,720,270
5305,text,723,322,243,26,26_median.png,1024,1448,966,348
5306,text,28,344,106,24,26_median.png,1024,1448,134,368
5307,text,192,346,74,24,26_median.png,1024,1448,266,370
5308,text,31,399,110,20,26_median.png,1024,1448,141,419
5309,text,267,397,111,29,26_median.png,1024,1448,378,426
5310,text,516,400,38,24,26_median.png,1024,1448,554,424
5311,text,601,403,42,20,26_median.png,1024,1448,643,423
5312,text,681,403,68,20,26_median.png,1024,1448,749,423
5313,text,787,403,80,20,26_median.png,1024,1448,867,423
5314,text,905,403,38,20,26_median.png,1024,1448,943,423
5315,text,180,430,288,24,26_median.png,1024,1448,468,454
5316,text,23,455,46,20,26_median.png,1024,1448,69,475
5317,text,148,456,230,24,26_median.png,1024,1448,378,480
5318,text,525,459,40,18,26_median.png,1024,1448,565,477
5319,text,617,459,60,18,26_median.png,1024,1448,677,477
5320,text,687,457,66,20,26_median.png,1024,1448,753,477
5321,text,824,454,134,26,26_median.png,1024,1448,958,480
5322,text,20,481,88,21,26_median.png,1024,1448,108,502
5323,text,149,483,312,20,26_median.png,1024,1448,461,503
5324,text,525,483,40,20,26_median.png,1024,1448,565,503
5325,text,617,483,60,20,26_median.png,1024,1448,677,503
5326,text,687,483,64,20,26_median.png,1024,1448,751,503
5327,text,824,482,134,24,26_median.png,1024,1448,958,506
5328,text,148,506,304,24,26_median.png,1024,1448,452,530
5329,text,523,509,40,20,26_median.png,1024,1448,563,529
5330,text,617,509,60,20,26_median.png,1024,1448,677,529
5331,text,685,509,68,20,26_median.png,1024,1448,753,529
5332,text,825,509,60,20,26_median.png,1024,1448,885,529
5333,text,899,509,58,20,26_median.png,1024,1448,957,529
5334,text,46,1152,72,24,26_median.png,1024,1448,118,1176
5335,text,159,1153,40,20,26_median.png,1024,1448,199,1173
5336,text,681,1153,100,20,26_median.png,1024,1448,781,1173
5337,text,878,1152,74,24,26_median.png,1024,1448,952,1176
5338,text,44,1180,74,24,26_median.png,1024,1448,118,1204
5339,text,151,1183,52,20,26_median.png,1024,1448,203,1203
5340,text,249,1183,60,20,26_median.png,1024,1448,309,1203
5341,text,671,1183,112,20,26_median.png,1024,1448,783,1203
5342,text,890,1182,62,24,26_median.png,1024,1448,952,1206
5343,text,878,1212,74,24,26_median.png,1024,1448,952,1236
5344,text,673,1213,114,20,26_median.png,1024,1448,787,1233
5345,text,14,1248,372,26,26_median.png,1024,1448,386,1274
5346,text,20,1275,459,25,26_median.png,1024,1448,479,1300
5347,text,20,1296,110,24,26_median.png,1024,1448,130,1320
5348,text,44,1354,372,24,26_median.png,1024,1448,416,1378
5349,text,423,1357,424,20,26_median.png,1024,1448,847,1377
5350,text,859,1357,38,18,26_median.png,1024,1448,897,1375
5351,text,171,1375,118,20,26_median.png,1024,1448,289,1395
5352,text,295,1375,154,20,26_median.png,1024,1448,449,1395
5353,text,455,1375,110,20,26_median.png,1024,1448,565,1395
5354,text,572,1375,208,20,26_median.png,1024,1448,780,1395
5355,text,59,505,22,27,26_median.png,1024,1448,81,532
5356,text,19,505,22,25,26_median.png,1024,1448,41,530
5357,text,523,135,96,16,27.png,1024,1448,619,151
5358,text,605,198,187,24,27.png,1024,1448,792,222
5359,text,571,235,86,18,27.png,1024,1448,657,253
5360,text,762,237,126,20,27.png,1024,1448,888,257
5361,text,82,331,113,36,27.png,1024,1448,195,367
5362,text,93,393,60,16,27.png,1024,1448,153,409
5363,text,235,395,38,16,27.png,1024,1448,273,411
5364,text,397,393,82,18,27.png,1024,1448,479,411
5365,text,101,425,68,16,27.png,1024,1448,169,441
5366,text,229,427,54,16,27.png,1024,1448,283,443
5367,text,407,427,108,16,27.png,1024,1448,515,443
5368,text,85,505,72,16,27.png,1024,1448,157,521
5369,text,339,505,84,18,27.png,1024,1448,423,523
5370,text,619,505,28,18,27.png,1024,1448,647,523
5371,text,697,507,78,16,27.png,1024,1448,775,523
5372,text,787,509,54,16,27.png,1024,1448,841,525
5373,text,863,505,80,20,27.png,1024,1448,943,525
5374,text,73,533,78,20,27.png,1024,1448,151,553
5375,text,207,537,43,16,27.png,1024,1448,250,553
5376,text,253,535,226,20,27.png,1024,1448,479,555
5377,text,507,537,24,18,27.png,1024,1448,531,555
5378,text,617,539,48,16,27.png,1024,1448,665,555
5379,text,715,539,54,16,27.png,1024,1448,769,555
5380,text,890,539,61,16,27.png,1024,1448,951,555
5381,text,73,557,104,18,27.png,1024,1448,177,575
5382,text,206,558,259,20,27.png,1024,1448,465,578
5383,text,507,559,24,18,27.png,1024,1448,531,577
5384,text,615,561,48,16,27.png,1024,1448,663,577
5385,text,719,561,50,18,27.png,1024,1448,769,579
5386,text,891,563,60,16,27.png,1024,1448,951,579
5387,text,73,579,104,20,27.png,1024,1448,177,599
5388,text,207,582,274,20,27.png,1024,1448,481,602
5389,text,507,581,24,18,27.png,1024,1448,531,599
5390,text,615,585,48,16,27.png,1024,1448,663,601
5391,text,721,585,48,16,27.png,1024,1448,769,601
5392,text,901,583,48,20,27.png,1024,1448,949,603
5393,text,207,599,28,14,27.png,1024,1448,235,613
5394,text,73,615,56,18,27.png,1024,1448,129,633
5395,text,204,616,213,21,27.png,1024,1448,417,637
5396,text,423,617,68,18,27.png,1024,1448,491,635
5397,text,505,617,26,18,27.png,1024,1448,531,635
5398,text,613,617,50,18,27.png,1024,1448,663,635
5399,text,721,617,48,20,27.png,1024,1448,769,637
5400,text,903,621,46,16,27.png,1024,1448,949,637
5401,text,205,633,90,18,27.png,1024,1448,295,651
5402,text,73,649,66,20,27.png,1024,1448,139,669
5403,text,205,652,190,21,27.png,1024,1448,395,673
5404,text,507,655,36,16,27.png,1024,1448,543,671
5405,text,619,653,40,18,27.png,1024,1448,659,671
5406,text,711,655,56,16,27.png,1024,1448,767,671
5407,text,903,655,46,16,27.png,1024,1448,949,671
5408,text,205,721,122,16,27.png,1024,1448,327,737
5409,text,67,961,38,16,27.png,1024,1448,105,977
5410,text,157,961,36,16,27.png,1024,1448,193,977
5411,text,239,961,38,16,27.png,1024,1448,277,977
5412,text,318,960,61,19,27.png,1024,1448,379,979
5413,text,433,961,60,18,27.png,1024,1448,493,979
5414,text,545,963,72,16,27.png,1024,1448,617,979
5415,text,659,963,70,16,27.png,1024,1448,729,979
5416,text,752,962,65,19,27.png,1024,1448,817,981
5417,text,845,961,100,18,27.png,1024,1448,945,979
5418,text,73,989,32,20,27.png,1024,1448,105,1009
5419,text,163,991,60,18,27.png,1024,1448,223,1009
5420,text,261,991,34,18,27.png,1024,1448,295,1009
5421,text,338,991,59,20,27.png,1024,1448,397,1011
5422,text,459,991,58,20,27.png,1024,1448,517,1011
5423,text,599,995,30,16,27.png,1024,1448,629,1011
5424,text,681,995,62,16,27.png,1024,1448,743,1011
5425,text,795,995,32,16,27.png,1024,1448,827,1011
5426,text,891,993,58,18,27.png,1024,1448,949,1011
5427,text,423,1039,158,18,27.png,1024,1448,581,1057
5428,text,613,1037,188,20,27.png,1024,1448,801,1057
5429,text,847,1039,62,18,27.png,1024,1448,909,1057
5430,text,66,1048,39,20,27.png,1024,1448,105,1068
5431,text,162,1049,63,18,27.png,1024,1448,225,1067
5432,text,338,1049,59,18,27.png,1024,1448,397,1067
5433,text,409,1097,414,18,27.png,1024,1448,823,1115
5434,text,59,1105,158,16,27.png,1024,1448,217,1121
5435,text,58,1120,215,18,27.png,1024,1448,273,1138
5436,text,57,1138,257,17,27.png,1024,1448,314,1155
5437,text,319,1137,106,18,27.png,1024,1448,425,1155
5438,text,59,1154,256,19,27.png,1024,1448,315,1173
5439,text,56,1181,139,16,27.png,1024,1448,195,1197
5440,text,57,1197,386,18,27.png,1024,1448,443,1215
5441,text,57,1215,28,16,27.png,1024,1448,85,1231
5442,text,95,1214,218,17,27.png,1024,1448,313,1231
5443,text,55,1247,370,20,27.png,1024,1448,425,1267
5444,text,523,135,96,16,27_contrasted.png,1024,1448,619,151
5445,text,605,198,187,24,27_contrasted.png,1024,1448,792,222
5446,text,571,235,86,18,27_contrasted.png,1024,1448,657,253
5447,text,762,237,126,20,27_contrasted.png,1024,1448,888,257
5448,text,82,331,113,36,27_contrasted.png,1024,1448,195,367
5449,text,93,393,60,16,27_contrasted.png,1024,1448,153,409
5450,text,235,395,38,16,27_contrasted.png,1024,1448,273,411
5451,text,397,393,82,18,27_contrasted.png,1024,1448,479,411
5452,text,101,425,68,16,27_contrasted.png,1024,1448,169,441
5453,text,229,427,54,16,27_contrasted.png,1024,1448,283,443
5454,text,407,427,108,16,27_contrasted.png,1024,1448,515,443
5455,text,85,505,72,16,27_contrasted.png,1024,1448,157,521
5456,text,339,505,84,18,27_contrasted.png,1024,1448,423,523
5457,text,619,505,28,18,27_contrasted.png,1024,1448,647,523
5458,text,697,507,78,16,27_contrasted.png,1024,1448,775,523
5459,text,787,509,54,16,27_contrasted.png,1024,1448,841,525
5460,text,863,505,80,20,27_contrasted.png,1024,1448,943,525
5461,text,73,533,78,20,27_contrasted.png,1024,1448,151,553
5462,text,207,537,43,16,27_contrasted.png,1024,1448,250,553
5463,text,253,535,226,20,27_contrasted.png,1024,1448,479,555
5464,text,507,537,24,18,27_contrasted.png,1024,1448,531,555
5465,text,617,539,48,16,27_contrasted.png,1024,1448,665,555
5466,text,715,539,54,16,27_contrasted.png,1024,1448,769,555
5467,text,890,539,61,16,27_contrasted.png,1024,1448,951,555
5468,text,73,557,104,18,27_contrasted.png,1024,1448,177,575
5469,text,206,558,259,20,27_contrasted.png,1024,1448,465,578
5470,text,507,559,24,18,27_contrasted.png,1024,1448,531,577
5471,text,615,561,48,16,27_contrasted.png,1024,1448,663,577
5472,text,719,561,50,18,27_contrasted.png,1024,1448,769,579
5473,text,891,563,60,16,27_contrasted.png,1024,1448,951,579
5474,text,73,579,104,20,27_contrasted.png,1024,1448,177,599
5475,text,207,582,274,20,27_contrasted.png,1024,1448,481,602
5476,text,507,581,24,18,27_contrasted.png,1024,1448,531,599
5477,text,615,585,48,16,27_contrasted.png,1024,1448,663,601
5478,text,721,585,48,16,27_contrasted.png,1024,1448,769,601
5479,text,901,583,48,20,27_contrasted.png,1024,1448,949,603
5480,text,207,599,28,14,27_contrasted.png,1024,1448,235,613
5481,text,73,615,56,18,27_contrasted.png,1024,1448,129,633
5482,text,204,616,213,21,27_contrasted.png,1024,1448,417,637
5483,text,423,617,68,18,27_contrasted.png,1024,1448,491,635
5484,text,505,617,26,18,27_contrasted.png,1024,1448,531,635
5485,text,613,617,50,18,27_contrasted.png,1024,1448,663,635
5486,text,721,617,48,20,27_contrasted.png,1024,1448,769,637
5487,text,903,621,46,16,27_contrasted.png,1024,1448,949,637
5488,text,205,633,90,18,27_contrasted.png,1024,1448,295,651
5489,text,73,649,66,20,27_contrasted.png,1024,1448,139,669
5490,text,205,652,190,21,27_contrasted.png,1024,1448,395,673
5491,text,507,655,36,16,27_contrasted.png,1024,1448,543,671
5492,text,619,653,40,18,27_contrasted.png,1024,1448,659,671
5493,text,711,655,56,16,27_contrasted.png,1024,1448,767,671
5494,text,903,655,46,16,27_contrasted.png,1024,1448,949,671
5495,text,205,721,122,16,27_contrasted.png,1024,1448,327,737
5496,text,67,961,38,16,27_contrasted.png,1024,1448,105,977
5497,text,157,961,36,16,27_contrasted.png,1024,1448,193,977
5498,text,239,961,38,16,27_contrasted.png,1024,1448,277,977
5499,text,318,960,61,19,27_contrasted.png,1024,1448,379,979
5500,text,433,961,60,18,27_contrasted.png,1024,1448,493,979
5501,text,545,963,72,16,27_contrasted.png,1024,1448,617,979
5502,text,659,963,70,16,27_contrasted.png,1024,1448,729,979
5503,text,752,962,65,19,27_contrasted.png,1024,1448,817,981
5504,text,845,961,100,18,27_contrasted.png,1024,1448,945,979
5505,text,73,989,32,20,27_contrasted.png,1024,1448,105,1009
5506,text,163,991,60,18,27_contrasted.png,1024,1448,223,1009
5507,text,261,991,34,18,27_contrasted.png,1024,1448,295,1009
5508,text,338,991,59,20,27_contrasted.png,1024,1448,397,1011
5509,text,459,991,58,20,27_contrasted.png,1024,1448,517,1011
5510,text,599,995,30,16,27_contrasted.png,1024,1448,629,1011
5511,text,681,995,62,16,27_contrasted.png,1024,1448,743,1011
5512,text,795,995,32,16,27_contrasted.png,1024,1448,827,1011
5513,text,891,993,58,18,27_contrasted.png,1024,1448,949,1011
5514,text,423,1039,158,18,27_contrasted.png,1024,1448,581,1057
5515,text,613,1037,188,20,27_contrasted.png,1024,1448,801,1057
5516,text,847,1039,62,18,27_contrasted.png,1024,1448,909,1057
5517,text,66,1048,39,20,27_contrasted.png,1024,1448,105,1068
5518,text,162,1049,63,18,27_contrasted.png,1024,1448,225,1067
5519,text,338,1049,59,18,27_contrasted.png,1024,1448,397,1067
5520,text,409,1097,414,18,27_contrasted.png,1024,1448,823,1115
5521,text,59,1105,158,16,27_contrasted.png,1024,1448,217,1121
5522,text,58,1120,215,18,27_contrasted.png,1024,1448,273,1138
5523,text,57,1138,257,17,27_contrasted.png,1024,1448,314,1155
5524,text,319,1137,106,18,27_contrasted.png,1024,1448,425,1155
5525,text,59,1154,256,19,27_contrasted.png,1024,1448,315,1173
5526,text,56,1181,139,16,27_contrasted.png,1024,1448,195,1197
5527,text,57,1197,386,18,27_contrasted.png,1024,1448,443,1215
5528,text,57,1215,28,16,27_contrasted.png,1024,1448,85,1231
5529,text,95,1214,218,17,27_contrasted.png,1024,1448,313,1231
5530,text,55,1247,370,20,27_contrasted.png,1024,1448,425,1267
5531,text,523,135,96,16,27_denoise.png,1024,1448,619,151
5532,text,605,198,187,24,27_denoise.png,1024,1448,792,222
5533,text,571,235,86,18,27_denoise.png,1024,1448,657,253
5534,text,762,237,126,20,27_denoise.png,1024,1448,888,257
5535,text,82,331,113,36,27_denoise.png,1024,1448,195,367
5536,text,93,393,60,16,27_denoise.png,1024,1448,153,409
5537,text,235,395,38,16,27_denoise.png,1024,1448,273,411
5538,text,397,393,82,18,27_denoise.png,1024,1448,479,411
5539,text,101,425,68,16,27_denoise.png,1024,1448,169,441
5540,text,229,427,54,16,27_denoise.png,1024,1448,283,443
5541,text,407,427,108,16,27_denoise.png,1024,1448,515,443
5542,text,85,505,72,16,27_denoise.png,1024,1448,157,521
5543,text,339,505,84,18,27_denoise.png,1024,1448,423,523
5544,text,619,505,28,18,27_denoise.png,1024,1448,647,523
5545,text,697,507,78,16,27_denoise.png,1024,1448,775,523
5546,text,787,509,54,16,27_denoise.png,1024,1448,841,525
5547,text,863,505,80,20,27_denoise.png,1024,1448,943,525
5548,text,73,533,78,20,27_denoise.png,1024,1448,151,553
5549,text,207,537,43,16,27_denoise.png,1024,1448,250,553
5550,text,253,535,226,20,27_denoise.png,1024,1448,479,555
5551,text,507,537,24,18,27_denoise.png,1024,1448,531,555
5552,text,617,539,48,16,27_denoise.png,1024,1448,665,555
5553,text,715,539,54,16,27_denoise.png,1024,1448,769,555
5554,text,890,539,61,16,27_denoise.png,1024,1448,951,555
5555,text,73,557,104,18,27_denoise.png,1024,1448,177,575
5556,text,206,558,259,20,27_denoise.png,1024,1448,465,578
5557,text,507,559,24,18,27_denoise.png,1024,1448,531,577
5558,text,615,561,48,16,27_denoise.png,1024,1448,663,577
5559,text,719,561,50,18,27_denoise.png,1024,1448,769,579
5560,text,891,563,60,16,27_denoise.png,1024,1448,951,579
5561,text,73,579,104,20,27_denoise.png,1024,1448,177,599
5562,text,207,582,274,20,27_denoise.png,1024,1448,481,602
5563,text,507,581,24,18,27_denoise.png,1024,1448,531,599
5564,text,615,585,48,16,27_denoise.png,1024,1448,663,601
5565,text,721,585,48,16,27_denoise.png,1024,1448,769,601
5566,text,901,583,48,20,27_denoise.png,1024,1448,949,603
5567,text,207,599,28,14,27_denoise.png,1024,1448,235,613
5568,text,73,615,56,18,27_denoise.png,1024,1448,129,633
5569,text,204,616,213,21,27_denoise.png,1024,1448,417,637
5570,text,423,617,68,18,27_denoise.png,1024,1448,491,635
5571,text,505,617,26,18,27_denoise.png,1024,1448,531,635
5572,text,613,617,50,18,27_denoise.png,1024,1448,663,635
5573,text,721,617,48,20,27_denoise.png,1024,1448,769,637
5574,text,903,621,46,16,27_denoise.png,1024,1448,949,637
5575,text,205,633,90,18,27_denoise.png,1024,1448,295,651
5576,text,73,649,66,20,27_denoise.png,1024,1448,139,669
5577,text,205,652,190,21,27_denoise.png,1024,1448,395,673
5578,text,507,655,36,16,27_denoise.png,1024,1448,543,671
5579,text,619,653,40,18,27_denoise.png,1024,1448,659,671
5580,text,711,655,56,16,27_denoise.png,1024,1448,767,671
5581,text,903,655,46,16,27_denoise.png,1024,1448,949,671
5582,text,205,721,122,16,27_denoise.png,1024,1448,327,737
5583,text,67,961,38,16,27_denoise.png,1024,1448,105,977
5584,text,157,961,36,16,27_denoise.png,1024,1448,193,977
5585,text,239,961,38,16,27_denoise.png,1024,1448,277,977
5586,text,318,960,61,19,27_denoise.png,1024,1448,379,979
5587,text,433,961,60,18,27_denoise.png,1024,1448,493,979
5588,text,545,963,72,16,27_denoise.png,1024,1448,617,979
5589,text,659,963,70,16,27_denoise.png,1024,1448,729,979
5590,text,752,962,65,19,27_denoise.png,1024,1448,817,981
5591,text,845,961,100,18,27_denoise.png,1024,1448,945,979
5592,text,73,989,32,20,27_denoise.png,1024,1448,105,1009
5593,text,163,991,60,18,27_denoise.png,1024,1448,223,1009
5594,text,261,991,34,18,27_denoise.png,1024,1448,295,1009
5595,text,338,991,59,20,27_denoise.png,1024,1448,397,1011
5596,text,459,991,58,20,27_denoise.png,1024,1448,517,1011
5597,text,599,995,30,16,27_denoise.png,1024,1448,629,1011
5598,text,681,995,62,16,27_denoise.png,1024,1448,743,1011
5599,text,795,995,32,16,27_denoise.png,1024,1448,827,1011
5600,text,891,993,58,18,27_denoise.png,1024,1448,949,1011
5601,text,423,1039,158,18,27_denoise.png,1024,1448,581,1057
5602,text,613,1037,188,20,27_denoise.png,1024,1448,801,1057
5603,text,847,1039,62,18,27_denoise.png,1024,1448,909,1057
5604,text,66,1048,39,20,27_denoise.png,1024,1448,105,1068
5605,text,162,1049,63,18,27_denoise.png,1024,1448,225,1067
5606,text,338,1049,59,18,27_denoise.png,1024,1448,397,1067
5607,text,409,1097,414,18,27_denoise.png,1024,1448,823,1115
5608,text,59,1105,158,16,27_denoise.png,1024,1448,217,1121
5609,text,58,1120,215,18,27_denoise.png,1024,1448,273,1138
5610,text,57,1138,257,17,27_denoise.png,1024,1448,314,1155
5611,text,319,1137,106,18,27_denoise.png,1024,1448,425,1155
5612,text,59,1154,256,19,27_denoise.png,1024,1448,315,1173
5613,text,56,1181,139,16,27_denoise.png,1024,1448,195,1197
5614,text,57,1197,386,18,27_denoise.png,1024,1448,443,1215
5615,text,57,1215,28,16,27_denoise.png,1024,1448,85,1231
5616,text,95,1214,218,17,27_denoise.png,1024,1448,313,1231
5617,text,55,1247,370,20,27_denoise.png,1024,1448,425,1267
5618,text,523,135,96,16,27_median.png,1024,1448,619,151
5619,text,605,198,187,24,27_median.png,1024,1448,792,222
5620,text,571,235,86,18,27_median.png,1024,1448,657,253
5621,text,762,237,126,20,27_median.png,1024,1448,888,257
5622,text,82,331,113,36,27_median.png,1024,1448,195,367
5623,text,93,393,60,16,27_median.png,1024,1448,153,409
5624,text,235,395,38,16,27_median.png,1024,1448,273,411
5625,text,397,393,82,18,27_median.png,1024,1448,479,411
5626,text,101,425,68,16,27_median.png,1024,1448,169,441
5627,text,229,427,54,16,27_median.png,1024,1448,283,443
5628,text,407,427,108,16,27_median.png,1024,1448,515,443
5629,text,85,505,72,16,27_median.png,1024,1448,157,521
5630,text,339,505,84,18,27_median.png,1024,1448,423,523
5631,text,619,505,28,18,27_median.png,1024,1448,647,523
5632,text,697,507,78,16,27_median.png,1024,1448,775,523
5633,text,787,509,54,16,27_median.png,1024,1448,841,525
5634,text,863,505,80,20,27_median.png,1024,1448,943,525
5635,text,73,533,78,20,27_median.png,1024,1448,151,553
5636,text,207,537,43,16,27_median.png,1024,1448,250,553
5637,text,253,535,226,20,27_median.png,1024,1448,479,555
5638,text,507,537,24,18,27_median.png,1024,1448,531,555
5639,text,617,539,48,16,27_median.png,1024,1448,665,555
5640,text,715,539,54,16,27_median.png,1024,1448,769,555
5641,text,890,539,61,16,27_median.png,1024,1448,951,555
5642,text,73,557,104,18,27_median.png,1024,1448,177,575
5643,text,206,558,259,20,27_median.png,1024,1448,465,578
5644,text,507,559,24,18,27_median.png,1024,1448,531,577
5645,text,615,561,48,16,27_median.png,1024,1448,663,577
5646,text,719,561,50,18,27_median.png,1024,1448,769,579
5647,text,891,563,60,16,27_median.png,1024,1448,951,579
5648,text,73,579,104,20,27_median.png,1024,1448,177,599
5649,text,207,582,274,20,27_median.png,1024,1448,481,602
5650,text,507,581,24,18,27_median.png,1024,1448,531,599
5651,text,615,585,48,16,27_median.png,1024,1448,663,601
5652,text,721,585,48,16,27_median.png,1024,1448,769,601
5653,text,901,583,48,20,27_median.png,1024,1448,949,603
5654,text,207,599,28,14,27_median.png,1024,1448,235,613
5655,text,73,615,56,18,27_median.png,1024,1448,129,633
5656,text,204,616,213,21,27_median.png,1024,1448,417,637
5657,text,423,617,68,18,27_median.png,1024,1448,491,635
5658,text,505,617,26,18,27_median.png,1024,1448,531,635
5659,text,613,617,50,18,27_median.png,1024,1448,663,635
5660,text,721,617,48,20,27_median.png,1024,1448,769,637
5661,text,903,621,46,16,27_median.png,1024,1448,949,637
5662,text,205,633,90,18,27_median.png,1024,1448,295,651
5663,text,73,649,66,20,27_median.png,1024,1448,139,669
5664,text,205,652,190,21,27_median.png,1024,1448,395,673
5665,text,507,655,36,16,27_median.png,1024,1448,543,671
5666,text,619,653,40,18,27_median.png,1024,1448,659,671
5667,text,711,655,56,16,27_median.png,1024,1448,767,671
5668,text,903,655,46,16,27_median.png,1024,1448,949,671
5669,text,205,721,122,16,27_median.png,1024,1448,327,737
5670,text,67,961,38,16,27_median.png,1024,1448,105,977
5671,text,157,961,36,16,27_median.png,1024,1448,193,977
5672,text,239,961,38,16,27_median.png,1024,1448,277,977
5673,text,318,960,61,19,27_median.png,1024,1448,379,979
5674,text,433,961,60,18,27_median.png,1024,1448,493,979
5675,text,545,963,72,16,27_median.png,1024,1448,617,979
5676,text,659,963,70,16,27_median.png,1024,1448,729,979
5677,text,752,962,65,19,27_median.png,1024,1448,817,981
5678,text,845,961,100,18,27_median.png,1024,1448,945,979
5679,text,73,989,32,20,27_median.png,1024,1448,105,1009
5680,text,163,991,60,18,27_median.png,1024,1448,223,1009
5681,text,261,991,34,18,27_median.png,1024,1448,295,1009
5682,text,338,991,59,20,27_median.png,1024,1448,397,1011
5683,text,459,991,58,20,27_median.png,1024,1448,517,1011
5684,text,599,995,30,16,27_median.png,1024,1448,629,1011
5685,text,681,995,62,16,27_median.png,1024,1448,743,1011
5686,text,795,995,32,16,27_median.png,1024,1448,827,1011
5687,text,891,993,58,18,27_median.png,1024,1448,949,1011
5688,text,423,1039,158,18,27_median.png,1024,1448,581,1057
5689,text,613,1037,188,20,27_median.png,1024,1448,801,1057
5690,text,847,1039,62,18,27_median.png,1024,1448,909,1057
5691,text,66,1048,39,20,27_median.png,1024,1448,105,1068
5692,text,162,1049,63,18,27_median.png,1024,1448,225,1067
5693,text,338,1049,59,18,27_median.png,1024,1448,397,1067
5694,text,409,1097,414,18,27_median.png,1024,1448,823,1115
5695,text,59,1105,158,16,27_median.png,1024,1448,217,1121
5696,text,58,1120,215,18,27_median.png,1024,1448,273,1138
5697,text,57,1138,257,17,27_median.png,1024,1448,314,1155
5698,text,319,1137,106,18,27_median.png,1024,1448,425,1155
5699,text,59,1154,256,19,27_median.png,1024,1448,315,1173
5700,text,56,1181,139,16,27_median.png,1024,1448,195,1197
5701,text,57,1197,386,18,27_median.png,1024,1448,443,1215
5702,text,57,1215,28,16,27_median.png,1024,1448,85,1231
5703,text,95,1214,218,17,27_median.png,1024,1448,313,1231
5704,text,55,1247,370,20,27_median.png,1024,1448,425,1267
5705,text,390,94,272,76,28.png,1024,1448,662,170
5706,text,509,163,144,18,28.png,1024,1448,653,181
5707,text,623,233,242,20,28.png,1024,1448,865,253
5708,text,706,258,104,24,28.png,1024,1448,810,282
5709,text,106,304,146,30,28.png,1024,1448,252,334
5710,text,262,304,142,30,28.png,1024,1448,404,334
5711,text,567,323,30,18,28.png,1024,1448,597,341
5712,text,603,323,124,20,28.png,1024,1448,727,343
5713,text,567,351,160,16,28.png,1024,1448,727,367
5714,text,728,345,116,26,28.png,1024,1448,844,371
5715,text,567,391,48,16,28.png,1024,1448,615,407
5716,text,565,411,30,16,28.png,1024,1448,595,427
5717,text,769,411,30,16,28.png,1024,1448,799,427
5718,text,809,407,90,18,28.png,1024,1448,899,425
5719,text,115,451,92,20,28.png,1024,1448,207,471
5720,text,409,453,104,20,28.png,1024,1448,513,473
5721,text,713,449,34,20,28.png,1024,1448,747,469
5722,text,813,453,22,16,28.png,1024,1448,835,469
5723,text,863,451,56,18,28.png,1024,1448,919,469
5724,text,101,491,122,16,28.png,1024,1448,223,507
5725,text,245,493,420,21,28.png,1024,1448,665,514
5726,text,707,491,48,18,28.png,1024,1448,755,509
5727,text,789,493,34,16,28.png,1024,1448,823,509
5728,text,867,489,60,20,28.png,1024,1448,927,509
5729,text,243,511,46,16,28.png,1024,1448,289,527
5730,text,80,1092,354,26,28.png,1024,1448,434,1118
5731,text,699,1109,74,20,28.png,1024,1448,773,1129
5732,text,863,1105,67,26,28.png,1024,1448,930,1131
5733,text,78,1125,384,26,28.png,1024,1448,462,1151
5734,text,699,1137,74,20,28.png,1024,1448,773,1157
5735,text,875,1137,52,20,28.png,1024,1448,927,1157
5736,text,697,1167,80,20,28.png,1024,1448,777,1187
5737,text,860,1167,67,20,28.png,1024,1448,927,1187
5738,text,89,1193,351,20,28.png,1024,1448,440,1213
5739,text,442,1193,155,20,28.png,1024,1448,597,1213
5740,text,86,1209,356,17,28.png,1024,1448,442,1226
5741,text,439,1211,275,16,28.png,1024,1448,714,1227
5742,text,126,1313,155,20,28.png,1024,1448,281,1333
5743,text,203,1334,172,18,28.png,1024,1448,375,1352
5744,text,192,1352,353,24,28.png,1024,1448,545,1376
5745,text,630,1394,230,26,28.png,1024,1448,860,1420
5746,text,778,450,30,18,28.png,1024,1448,808,468
5747,text,285,1313,94,21,28.png,1024,1448,379,1334
5748,text,385,1313,123,21,28.png,1024,1448,508,1334
5749,text,513,1313,279,21,28.png,1024,1448,792,1334
5750,text,801,1313,96,20,28.png,1024,1448,897,1333
5751,text,379,1334,446,18,28.png,1024,1448,825,1352
5752,text,545,1352,138,23,28.png,1024,1448,683,1375
5753,text,683,1352,152,20,28.png,1024,1448,835,1372
5754,text,390,94,272,76,28_contrasted.png,1024,1448,662,170
5755,text,509,163,144,18,28_contrasted.png,1024,1448,653,181
5756,text,623,233,242,20,28_contrasted.png,1024,1448,865,253
5757,text,706,258,104,24,28_contrasted.png,1024,1448,810,282
5758,text,106,304,146,30,28_contrasted.png,1024,1448,252,334
5759,text,262,304,142,30,28_contrasted.png,1024,1448,404,334
5760,text,567,323,30,18,28_contrasted.png,1024,1448,597,341
5761,text,603,323,124,20,28_contrasted.png,1024,1448,727,343
5762,text,567,351,160,16,28_contrasted.png,1024,1448,727,367
5763,text,728,345,116,26,28_contrasted.png,1024,1448,844,371
5764,text,567,391,48,16,28_contrasted.png,1024,1448,615,407
5765,text,565,411,30,16,28_contrasted.png,1024,1448,595,427
5766,text,769,411,30,16,28_contrasted.png,1024,1448,799,427
5767,text,809,407,90,18,28_contrasted.png,1024,1448,899,425
5768,text,115,451,92,20,28_contrasted.png,1024,1448,207,471
5769,text,409,453,104,20,28_contrasted.png,1024,1448,513,473
5770,text,713,449,34,20,28_contrasted.png,1024,1448,747,469
5771,text,813,453,22,16,28_contrasted.png,1024,1448,835,469
5772,text,863,451,56,18,28_contrasted.png,1024,1448,919,469
5773,text,101,491,122,16,28_contrasted.png,1024,1448,223,507
5774,text,245,493,420,21,28_contrasted.png,1024,1448,665,514
5775,text,707,491,48,18,28_contrasted.png,1024,1448,755,509
5776,text,789,493,34,16,28_contrasted.png,1024,1448,823,509
5777,text,867,489,60,20,28_contrasted.png,1024,1448,927,509
5778,text,243,511,46,16,28_contrasted.png,1024,1448,289,527
5779,text,80,1092,354,26,28_contrasted.png,1024,1448,434,1118
5780,text,699,1109,74,20,28_contrasted.png,1024,1448,773,1129
5781,text,863,1105,67,26,28_contrasted.png,1024,1448,930,1131
5782,text,78,1125,384,26,28_contrasted.png,1024,1448,462,1151
5783,text,699,1137,74,20,28_contrasted.png,1024,1448,773,1157
5784,text,875,1137,52,20,28_contrasted.png,1024,1448,927,1157
5785,text,697,1167,80,20,28_contrasted.png,1024,1448,777,1187
5786,text,860,1167,67,20,28_contrasted.png,1024,1448,927,1187
5787,text,89,1193,351,20,28_contrasted.png,1024,1448,440,1213
5788,text,442,1193,155,20,28_contrasted.png,1024,1448,597,1213
5789,text,86,1209,356,17,28_contrasted.png,1024,1448,442,1226
5790,text,439,1211,275,16,28_contrasted.png,1024,1448,714,1227
5791,text,126,1313,155,20,28_contrasted.png,1024,1448,281,1333
5792,text,203,1334,172,18,28_contrasted.png,1024,1448,375,1352
5793,text,192,1352,353,24,28_contrasted.png,1024,1448,545,1376
5794,text,630,1394,230,26,28_contrasted.png,1024,1448,860,1420
5795,text,778,450,30,18,28_contrasted.png,1024,1448,808,468
5796,text,285,1313,94,21,28_contrasted.png,1024,1448,379,1334
5797,text,385,1313,123,21,28_contrasted.png,1024,1448,508,1334
5798,text,513,1313,279,21,28_contrasted.png,1024,1448,792,1334
5799,text,801,1313,96,20,28_contrasted.png,1024,1448,897,1333
5800,text,379,1334,446,18,28_contrasted.png,1024,1448,825,1352
5801,text,545,1352,138,23,28_contrasted.png,1024,1448,683,1375
5802,text,683,1352,152,20,28_contrasted.png,1024,1448,835,1372
5803,text,390,94,272,76,28_denoise.png,1024,1448,662,170
5804,text,509,163,144,18,28_denoise.png,1024,1448,653,181
5805,text,623,233,242,20,28_denoise.png,1024,1448,865,253
5806,text,706,258,104,24,28_denoise.png,1024,1448,810,282
5807,text,106,304,146,30,28_denoise.png,1024,1448,252,334
5808,text,262,304,142,30,28_denoise.png,1024,1448,404,334
5809,text,567,323,30,18,28_denoise.png,1024,1448,597,341
5810,text,603,323,124,20,28_denoise.png,1024,1448,727,343
5811,text,567,351,160,16,28_denoise.png,1024,1448,727,367
5812,text,728,345,116,26,28_denoise.png,1024,1448,844,371
5813,text,567,391,48,16,28_denoise.png,1024,1448,615,407
5814,text,565,411,30,16,28_denoise.png,1024,1448,595,427
5815,text,769,411,30,16,28_denoise.png,1024,1448,799,427
5816,text,809,407,90,18,28_denoise.png,1024,1448,899,425
5817,text,115,451,92,20,28_denoise.png,1024,1448,207,471
5818,text,409,453,104,20,28_denoise.png,1024,1448,513,473
5819,text,713,449,34,20,28_denoise.png,1024,1448,747,469
5820,text,813,453,22,16,28_denoise.png,1024,1448,835,469
5821,text,863,451,56,18,28_denoise.png,1024,1448,919,469
5822,text,101,491,122,16,28_denoise.png,1024,1448,223,507
5823,text,245,493,420,21,28_denoise.png,1024,1448,665,514
5824,text,707,491,48,18,28_denoise.png,1024,1448,755,509
5825,text,789,493,34,16,28_denoise.png,1024,1448,823,509
5826,text,867,489,60,20,28_denoise.png,1024,1448,927,509
5827,text,243,511,46,16,28_denoise.png,1024,1448,289,527
5828,text,80,1092,354,26,28_denoise.png,1024,1448,434,1118
5829,text,699,1109,74,20,28_denoise.png,1024,1448,773,1129
5830,text,863,1105,67,26,28_denoise.png,1024,1448,930,1131
5831,text,78,1125,384,26,28_denoise.png,1024,1448,462,1151
5832,text,699,1137,74,20,28_denoise.png,1024,1448,773,1157
5833,text,875,1137,52,20,28_denoise.png,1024,1448,927,1157
5834,text,697,1167,80,20,28_denoise.png,1024,1448,777,1187
5835,text,860,1167,67,20,28_denoise.png,1024,1448,927,1187
5836,text,89,1193,351,20,28_denoise.png,1024,1448,440,1213
5837,text,442,1193,155,20,28_denoise.png,1024,1448,597,1213
5838,text,86,1209,356,17,28_denoise.png,1024,1448,442,1226
5839,text,439,1211,275,16,28_denoise.png,1024,1448,714,1227
5840,text,126,1313,155,20,28_denoise.png,1024,1448,281,1333
5841,text,203,1334,172,18,28_denoise.png,1024,1448,375,1352
5842,text,192,1352,353,24,28_denoise.png,1024,1448,545,1376
5843,text,630,1394,230,26,28_denoise.png,1024,1448,860,1420
5844,text,778,450,30,18,28_denoise.png,1024,1448,808,468
5845,text,285,1313,94,21,28_denoise.png,1024,1448,379,1334
5846,text,385,1313,123,21,28_denoise.png,1024,1448,508,1334
5847,text,513,1313,279,21,28_denoise.png,1024,1448,792,1334
5848,text,801,1313,96,20,28_denoise.png,1024,1448,897,1333
5849,text,379,1334,446,18,28_denoise.png,1024,1448,825,1352
5850,text,545,1352,138,23,28_denoise.png,1024,1448,683,1375
5851,text,683,1352,152,20,28_denoise.png,1024,1448,835,1372
5852,text,390,94,272,76,28_median.png,1024,1448,662,170
5853,text,509,163,144,18,28_median.png,1024,1448,653,181
5854,text,623,233,242,20,28_median.png,1024,1448,865,253
5855,text,706,258,104,24,28_median.png,1024,1448,810,282
5856,text,106,304,146,30,28_median.png,1024,1448,252,334
5857,text,262,304,142,30,28_median.png,1024,1448,404,334
5858,text,567,323,30,18,28_median.png,1024,1448,597,341
5859,text,603,323,124,20,28_median.png,1024,1448,727,343
5860,text,567,351,160,16,28_median.png,1024,1448,727,367
5861,text,728,345,116,26,28_median.png,1024,1448,844,371
5862,text,567,391,48,16,28_median.png,1024,1448,615,407
5863,text,565,411,30,16,28_median.png,1024,1448,595,427
5864,text,769,411,30,16,28_median.png,1024,1448,799,427
5865,text,809,407,90,18,28_median.png,1024,1448,899,425
5866,text,115,451,92,20,28_median.png,1024,1448,207,471
5867,text,409,453,104,20,28_median.png,1024,1448,513,473
5868,text,713,449,34,20,28_median.png,1024,1448,747,469
5869,text,813,453,22,16,28_median.png,1024,1448,835,469
5870,text,863,451,56,18,28_median.png,1024,1448,919,469
5871,text,101,491,122,16,28_median.png,1024,1448,223,507
5872,text,245,493,420,21,28_median.png,1024,1448,665,514
5873,text,707,491,48,18,28_median.png,1024,1448,755,509
5874,text,789,493,34,16,28_median.png,1024,1448,823,509
5875,text,867,489,60,20,28_median.png,1024,1448,927,509
5876,text,243,511,46,16,28_median.png,1024,1448,289,527
5877,text,80,1092,354,26,28_median.png,1024,1448,434,1118
5878,text,699,1109,74,20,28_median.png,1024,1448,773,1129
5879,text,863,1105,67,26,28_median.png,1024,1448,930,1131
5880,text,78,1125,384,26,28_median.png,1024,1448,462,1151
5881,text,699,1137,74,20,28_median.png,1024,1448,773,1157
5882,text,875,1137,52,20,28_median.png,1024,1448,927,1157
5883,text,697,1167,80,20,28_median.png,1024,1448,777,1187
5884,text,860,1167,67,20,28_median.png,1024,1448,927,1187
5885,text,89,1193,351,20,28_median.png,1024,1448,440,1213
5886,text,442,1193,155,20,28_median.png,1024,1448,597,1213
5887,text,86,1209,356,17,28_median.png,1024,1448,442,1226
5888,text,439,1211,275,16,28_median.png,1024,1448,714,1227
5889,text,126,1313,155,20,28_median.png,1024,1448,281,1333
5890,text,203,1334,172,18,28_median.png,1024,1448,375,1352
5891,text,192,1352,353,24,28_median.png,1024,1448,545,1376
5892,text,630,1394,230,26,28_median.png,1024,1448,860,1420
5893,text,778,450,30,18,28_median.png,1024,1448,808,468
5894,text,285,1313,94,21,28_median.png,1024,1448,379,1334
5895,text,385,1313,123,21,28_median.png,1024,1448,508,1334
5896,text,513,1313,279,21,28_median.png,1024,1448,792,1334
5897,text,801,1313,96,20,28_median.png,1024,1448,897,1333
5898,text,379,1334,446,18,28_median.png,1024,1448,825,1352
5899,text,545,1352,138,23,28_median.png,1024,1448,683,1375
5900,text,683,1352,152,20,28_median.png,1024,1448,835,1372
5901,text,183,95,40,18,29.png,1024,1430,223,113
5902,text,270,83,482,30,29.png,1024,1430,752,113
5903,text,69,251,70,20,29.png,1024,1430,139,271
5904,text,67,271,221,25,29.png,1024,1430,288,296
5905,text,68,295,274,25,29.png,1024,1430,342,320
5906,text,349,299,154,20,29.png,1024,1430,503,319
5907,text,80,354,168,24,29.png,1024,1430,248,378
5908,text,260,356,160,24,29.png,1024,1430,420,380
5909,text,597,402,266,24,29.png,1024,1430,863,426
5910,text,658,422,206,24,29.png,1024,1430,864,446
5911,text,123,525,32,14,29.png,1024,1430,155,539
5912,text,285,525,70,16,29.png,1024,1430,355,541
5913,text,455,527,24,12,29.png,1024,1430,479,539
5914,text,507,525,42,16,29.png,1024,1430,549,541
5915,text,581,525,50,16,29.png,1024,1430,631,541
5916,text,661,529,44,12,29.png,1024,1430,705,541
5917,text,733,527,48,16,29.png,1024,1430,781,543
5918,text,813,529,28,12,29.png,1024,1430,841,541
5919,text,869,527,74,16,29.png,1024,1430,943,543
5920,text,89,551,98,16,29.png,1024,1430,187,567
5921,text,267,553,132,16,29.png,1024,1430,399,569
5922,text,509,555,50,16,29.png,1024,1430,559,571
5923,text,587,555,50,16,29.png,1024,1430,637,571
5924,text,693,557,22,14,29.png,1024,1430,715,571
5925,text,755,557,28,14,29.png,1024,1430,783,571
5926,text,809,557,44,14,29.png,1024,1430,853,571
5927,text,901,557,44,16,29.png,1024,1430,945,573
5928,text,89,581,96,16,29.png,1024,1430,185,597
5929,text,279,583,48,14,29.png,1024,1430,327,597
5930,text,326,580,71,20,29.png,1024,1430,397,600
5931,text,523,585,36,14,29.png,1024,1430,559,599
5932,text,601,585,36,14,29.png,1024,1430,637,599
5933,text,693,585,22,14,29.png,1024,1430,715,599
5934,text,755,585,28,16,29.png,1024,1430,783,601
5935,text,815,585,36,16,29.png,1024,1430,851,601
5936,text,915,587,28,14,29.png,1024,1430,943,601
5937,text,89,605,42,14,29.png,1024,1430,131,619
5938,text,135,605,28,14,29.png,1024,1430,163,619
5939,text,899,609,44,16,29.png,1024,1430,943,625
5940,text,81,663,84,16,29.png,1024,1430,165,679
5941,text,197,661,36,18,29.png,1024,1430,233,679
5942,text,129,695,26,16,29.png,1024,1430,155,711
5943,text,221,695,66,16,29.png,1024,1430,287,711
5944,text,355,697,22,14,29.png,1024,1430,377,711
5945,text,471,697,38,16,29.png,1024,1430,509,713
5946,text,595,699,28,14,29.png,1024,1430,623,713
5947,text,89,719,68,14,29.png,1024,1430,157,733
5948,text,259,719,38,16,29.png,1024,1430,297,735
5949,text,369,719,52,16,29.png,1024,1430,421,735
5950,text,501,721,42,16,29.png,1024,1430,543,737
5951,text,607,721,52,16,29.png,1024,1430,659,737
5952,text,87,741,44,16,29.png,1024,1430,131,757
5953,text,355,743,66,14,29.png,1024,1430,421,757
5954,text,487,743,56,16,29.png,1024,1430,543,759
5955,text,615,745,42,14,29.png,1024,1430,657,759
5956,text,77,799,160,18,29.png,1024,1430,237,817
5957,text,163,833,108,16,29.png,1024,1430,271,849
5958,text,401,835,42,14,29.png,1024,1430,443,849
5959,text,533,835,52,14,29.png,1024,1430,585,849
5960,text,87,855,60,14,29.png,1024,1430,147,869
5961,text,429,857,54,14,29.png,1024,1430,483,871
5962,text,569,857,52,16,29.png,1024,1430,621,873
5963,text,856,1318,102,10,29.png,1024,1430,958,1328
5964,text,297,1337,416,16,29.png,1024,1430,713,1353
5965,text,85,1355,78,16,29.png,1024,1430,163,1371
5966,text,169,1353,355,18,29.png,1024,1430,524,1371
5967,text,527,1355,66,16,29.png,1024,1430,593,1371
5968,text,601,1355,74,16,29.png,1024,1430,675,1371
5969,text,681,1355,26,16,29.png,1024,1430,707,1371
5970,text,713,1355,94,16,29.png,1024,1430,807,1371
5971,text,813,1353,112,18,29.png,1024,1430,925,1371
5972,text,255,1373,50,16,29.png,1024,1430,305,1389
5973,text,311,1373,34,14,29.png,1024,1430,345,1387
5974,text,351,1373,64,16,29.png,1024,1430,415,1389
5975,text,423,1373,94,16,29.png,1024,1430,517,1389
5976,text,481,1366,36,11,29.png,1024,1430,517,1377
5977,text,525,1371,38,18,29.png,1024,1430,563,1389
5978,text,569,1373,56,16,29.png,1024,1430,625,1389
5979,text,631,1373,148,16,29.png,1024,1430,779,1389
5980,text,165,665,33,17,29.png,1024,1430,198,682
5981,text,469,552,14,19,29.png,1024,1430,483,571
5982,text,469,582,14,19,29.png,1024,1430,483,601
5983,text,229,1372,19,18,29.png,1024,1430,248,1390
5984,text,69,158,107,27,29.png,1024,1430,176,185
5985,text,183,95,40,18,29_contrasted.png,1024,1430,223,113
5986,text,270,83,482,30,29_contrasted.png,1024,1430,752,113
5987,text,69,251,70,20,29_contrasted.png,1024,1430,139,271
5988,text,67,271,221,25,29_contrasted.png,1024,1430,288,296
5989,text,68,295,274,25,29_contrasted.png,1024,1430,342,320
5990,text,349,299,154,20,29_contrasted.png,1024,1430,503,319
5991,text,80,354,168,24,29_contrasted.png,1024,1430,248,378
5992,text,260,356,160,24,29_contrasted.png,1024,1430,420,380
5993,text,597,402,266,24,29_contrasted.png,1024,1430,863,426
5994,text,658,422,206,24,29_contrasted.png,1024,1430,864,446
5995,text,123,525,32,14,29_contrasted.png,1024,1430,155,539
5996,text,285,525,70,16,29_contrasted.png,1024,1430,355,541
5997,text,455,527,24,12,29_contrasted.png,1024,1430,479,539
5998,text,507,525,42,16,29_contrasted.png,1024,1430,549,541
5999,text,581,525,50,16,29_contrasted.png,1024,1430,631,541
6000,text,661,529,44,12,29_contrasted.png,1024,1430,705,541
6001,text,733,527,48,16,29_contrasted.png,1024,1430,781,543
6002,text,813,529,28,12,29_contrasted.png,1024,1430,841,541
6003,text,869,527,74,16,29_contrasted.png,1024,1430,943,543
6004,text,89,551,98,16,29_contrasted.png,1024,1430,187,567
6005,text,267,553,132,16,29_contrasted.png,1024,1430,399,569
6006,text,509,555,50,16,29_contrasted.png,1024,1430,559,571
6007,text,587,555,50,16,29_contrasted.png,1024,1430,637,571
6008,text,693,557,22,14,29_contrasted.png,1024,1430,715,571
6009,text,755,557,28,14,29_contrasted.png,1024,1430,783,571
6010,text,809,557,44,14,29_contrasted.png,1024,1430,853,571
6011,text,901,557,44,16,29_contrasted.png,1024,1430,945,573
6012,text,89,581,96,16,29_contrasted.png,1024,1430,185,597
6013,text,279,583,48,14,29_contrasted.png,1024,1430,327,597
6014,text,326,580,71,20,29_contrasted.png,1024,1430,397,600
6015,text,523,585,36,14,29_contrasted.png,1024,1430,559,599
6016,text,601,585,36,14,29_contrasted.png,1024,1430,637,599
6017,text,693,585,22,14,29_contrasted.png,1024,1430,715,599
6018,text,755,585,28,16,29_contrasted.png,1024,1430,783,601
6019,text,815,585,36,16,29_contrasted.png,1024,1430,851,601
6020,text,915,587,28,14,29_contrasted.png,1024,1430,943,601
6021,text,89,605,42,14,29_contrasted.png,1024,1430,131,619
6022,text,135,605,28,14,29_contrasted.png,1024,1430,163,619
6023,text,899,609,44,16,29_contrasted.png,1024,1430,943,625
6024,text,81,663,84,16,29_contrasted.png,1024,1430,165,679
6025,text,197,661,36,18,29_contrasted.png,1024,1430,233,679
6026,text,129,695,26,16,29_contrasted.png,1024,1430,155,711
6027,text,221,695,66,16,29_contrasted.png,1024,1430,287,711
6028,text,355,697,22,14,29_contrasted.png,1024,1430,377,711
6029,text,471,697,38,16,29_contrasted.png,1024,1430,509,713
6030,text,595,699,28,14,29_contrasted.png,1024,1430,623,713
6031,text,89,719,68,14,29_contrasted.png,1024,1430,157,733
6032,text,259,719,38,16,29_contrasted.png,1024,1430,297,735
6033,text,369,719,52,16,29_contrasted.png,1024,1430,421,735
6034,text,501,721,42,16,29_contrasted.png,1024,1430,543,737
6035,text,607,721,52,16,29_contrasted.png,1024,1430,659,737
6036,text,87,741,44,16,29_contrasted.png,1024,1430,131,757
6037,text,355,743,66,14,29_contrasted.png,1024,1430,421,757
6038,text,487,743,56,16,29_contrasted.png,1024,1430,543,759
6039,text,615,745,42,14,29_contrasted.png,1024,1430,657,759
6040,text,77,799,160,18,29_contrasted.png,1024,1430,237,817
6041,text,163,833,108,16,29_contrasted.png,1024,1430,271,849
6042,text,401,835,42,14,29_contrasted.png,1024,1430,443,849
6043,text,533,835,52,14,29_contrasted.png,1024,1430,585,849
6044,text,87,855,60,14,29_contrasted.png,1024,1430,147,869
6045,text,429,857,54,14,29_contrasted.png,1024,1430,483,871
6046,text,569,857,52,16,29_contrasted.png,1024,1430,621,873
6047,text,856,1318,102,10,29_contrasted.png,1024,1430,958,1328
6048,text,297,1337,416,16,29_contrasted.png,1024,1430,713,1353
6049,text,85,1355,78,16,29_contrasted.png,1024,1430,163,1371
6050,text,169,1353,355,18,29_contrasted.png,1024,1430,524,1371
6051,text,527,1355,66,16,29_contrasted.png,1024,1430,593,1371
6052,text,601,1355,74,16,29_contrasted.png,1024,1430,675,1371
6053,text,681,1355,26,16,29_contrasted.png,1024,1430,707,1371
6054,text,713,1355,94,16,29_contrasted.png,1024,1430,807,1371
6055,text,813,1353,112,18,29_contrasted.png,1024,1430,925,1371
6056,text,255,1373,50,16,29_contrasted.png,1024,1430,305,1389
6057,text,311,1373,34,14,29_contrasted.png,1024,1430,345,1387
6058,text,351,1373,64,16,29_contrasted.png,1024,1430,415,1389
6059,text,423,1373,94,16,29_contrasted.png,1024,1430,517,1389
6060,text,481,1366,36,11,29_contrasted.png,1024,1430,517,1377
6061,text,525,1371,38,18,29_contrasted.png,1024,1430,563,1389
6062,text,569,1373,56,16,29_contrasted.png,1024,1430,625,1389
6063,text,631,1373,148,16,29_contrasted.png,1024,1430,779,1389
6064,text,165,665,33,17,29_contrasted.png,1024,1430,198,682
6065,text,469,552,14,19,29_contrasted.png,1024,1430,483,571
6066,text,469,582,14,19,29_contrasted.png,1024,1430,483,601
6067,text,229,1372,19,18,29_contrasted.png,1024,1430,248,1390
6068,text,69,158,107,27,29_contrasted.png,1024,1430,176,185
6069,text,183,95,40,18,29_denoise.png,1024,1430,223,113
6070,text,270,83,482,30,29_denoise.png,1024,1430,752,113
6071,text,69,251,70,20,29_denoise.png,1024,1430,139,271
6072,text,67,271,221,25,29_denoise.png,1024,1430,288,296
6073,text,68,295,274,25,29_denoise.png,1024,1430,342,320
6074,text,349,299,154,20,29_denoise.png,1024,1430,503,319
6075,text,80,354,168,24,29_denoise.png,1024,1430,248,378
6076,text,260,356,160,24,29_denoise.png,1024,1430,420,380
6077,text,597,402,266,24,29_denoise.png,1024,1430,863,426
6078,text,658,422,206,24,29_denoise.png,1024,1430,864,446
6079,text,123,525,32,14,29_denoise.png,1024,1430,155,539
6080,text,285,525,70,16,29_denoise.png,1024,1430,355,541
6081,text,455,527,24,12,29_denoise.png,1024,1430,479,539
6082,text,507,525,42,16,29_denoise.png,1024,1430,549,541
6083,text,581,525,50,16,29_denoise.png,1024,1430,631,541
6084,text,661,529,44,12,29_denoise.png,1024,1430,705,541
6085,text,733,527,48,16,29_denoise.png,1024,1430,781,543
6086,text,813,529,28,12,29_denoise.png,1024,1430,841,541
6087,text,869,527,74,16,29_denoise.png,1024,1430,943,543
6088,text,89,551,98,16,29_denoise.png,1024,1430,187,567
6089,text,267,553,132,16,29_denoise.png,1024,1430,399,569
6090,text,509,555,50,16,29_denoise.png,1024,1430,559,571
6091,text,587,555,50,16,29_denoise.png,1024,1430,637,571
6092,text,693,557,22,14,29_denoise.png,1024,1430,715,571
6093,text,755,557,28,14,29_denoise.png,1024,1430,783,571
6094,text,809,557,44,14,29_denoise.png,1024,1430,853,571
6095,text,901,557,44,16,29_denoise.png,1024,1430,945,573
6096,text,89,581,96,16,29_denoise.png,1024,1430,185,597
6097,text,279,583,48,14,29_denoise.png,1024,1430,327,597
6098,text,326,580,71,20,29_denoise.png,1024,1430,397,600
6099,text,523,585,36,14,29_denoise.png,1024,1430,559,599
6100,text,601,585,36,14,29_denoise.png,1024,1430,637,599
6101,text,693,585,22,14,29_denoise.png,1024,1430,715,599
6102,text,755,585,28,16,29_denoise.png,1024,1430,783,601
6103,text,815,585,36,16,29_denoise.png,1024,1430,851,601
6104,text,915,587,28,14,29_denoise.png,1024,1430,943,601
6105,text,89,605,42,14,29_denoise.png,1024,1430,131,619
6106,text,135,605,28,14,29_denoise.png,1024,1430,163,619
6107,text,899,609,44,16,29_denoise.png,1024,1430,943,625
6108,text,81,663,84,16,29_denoise.png,1024,1430,165,679
6109,text,197,661,36,18,29_denoise.png,1024,1430,233,679
6110,text,129,695,26,16,29_denoise.png,1024,1430,155,711
6111,text,221,695,66,16,29_denoise.png,1024,1430,287,711
6112,text,355,697,22,14,29_denoise.png,1024,1430,377,711
6113,text,471,697,38,16,29_denoise.png,1024,1430,509,713
6114,text,595,699,28,14,29_denoise.png,1024,1430,623,713
6115,text,89,719,68,14,29_denoise.png,1024,1430,157,733
6116,text,259,719,38,16,29_denoise.png,1024,1430,297,735
6117,text,369,719,52,16,29_denoise.png,1024,1430,421,735
6118,text,501,721,42,16,29_denoise.png,1024,1430,543,737
6119,text,607,721,52,16,29_denoise.png,1024,1430,659,737
6120,text,87,741,44,16,29_denoise.png,1024,1430,131,757
6121,text,355,743,66,14,29_denoise.png,1024,1430,421,757
6122,text,487,743,56,16,29_denoise.png,1024,1430,543,759
6123,text,615,745,42,14,29_denoise.png,1024,1430,657,759
6124,text,77,799,160,18,29_denoise.png,1024,1430,237,817
6125,text,163,833,108,16,29_denoise.png,1024,1430,271,849
6126,text,401,835,42,14,29_denoise.png,1024,1430,443,849
6127,text,533,835,52,14,29_denoise.png,1024,1430,585,849
6128,text,87,855,60,14,29_denoise.png,1024,1430,147,869
6129,text,429,857,54,14,29_denoise.png,1024,1430,483,871
6130,text,569,857,52,16,29_denoise.png,1024,1430,621,873
6131,text,856,1318,102,10,29_denoise.png,1024,1430,958,1328
6132,text,297,1337,416,16,29_denoise.png,1024,1430,713,1353
6133,text,85,1355,78,16,29_denoise.png,1024,1430,163,1371
6134,text,169,1353,355,18,29_denoise.png,1024,1430,524,1371
6135,text,527,1355,66,16,29_denoise.png,1024,1430,593,1371
6136,text,601,1355,74,16,29_denoise.png,1024,1430,675,1371
6137,text,681,1355,26,16,29_denoise.png,1024,1430,707,1371
6138,text,713,1355,94,16,29_denoise.png,1024,1430,807,1371
6139,text,813,1353,112,18,29_denoise.png,1024,1430,925,1371
6140,text,255,1373,50,16,29_denoise.png,1024,1430,305,1389
6141,text,311,1373,34,14,29_denoise.png,1024,1430,345,1387
6142,text,351,1373,64,16,29_denoise.png,1024,1430,415,1389
6143,text,423,1373,94,16,29_denoise.png,1024,1430,517,1389
6144,text,481,1366,36,11,29_denoise.png,1024,1430,517,1377
6145,text,525,1371,38,18,29_denoise.png,1024,1430,563,1389
6146,text,569,1373,56,16,29_denoise.png,1024,1430,625,1389
6147,text,631,1373,148,16,29_denoise.png,1024,1430,779,1389
6148,text,165,665,33,17,29_denoise.png,1024,1430,198,682
6149,text,469,552,14,19,29_denoise.png,1024,1430,483,571
6150,text,469,582,14,19,29_denoise.png,1024,1430,483,601
6151,text,229,1372,19,18,29_denoise.png,1024,1430,248,1390
6152,text,69,158,107,27,29_denoise.png,1024,1430,176,185
6153,text,183,95,40,18,29_median.png,1024,1430,223,113
6154,text,270,83,482,30,29_median.png,1024,1430,752,113
6155,text,69,251,70,20,29_median.png,1024,1430,139,271
6156,text,67,271,221,25,29_median.png,1024,1430,288,296
6157,text,68,295,274,25,29_median.png,1024,1430,342,320
6158,text,349,299,154,20,29_median.png,1024,1430,503,319
6159,text,80,354,168,24,29_median.png,1024,1430,248,378
6160,text,260,356,160,24,29_median.png,1024,1430,420,380
6161,text,597,402,266,24,29_median.png,1024,1430,863,426
6162,text,658,422,206,24,29_median.png,1024,1430,864,446
6163,text,123,525,32,14,29_median.png,1024,1430,155,539
6164,text,285,525,70,16,29_median.png,1024,1430,355,541
6165,text,455,527,24,12,29_median.png,1024,1430,479,539
6166,text,507,525,42,16,29_median.png,1024,1430,549,541
6167,text,581,525,50,16,29_median.png,1024,1430,631,541
6168,text,661,529,44,12,29_median.png,1024,1430,705,541
6169,text,733,527,48,16,29_median.png,1024,1430,781,543
6170,text,813,529,28,12,29_median.png,1024,1430,841,541
6171,text,869,527,74,16,29_median.png,1024,1430,943,543
6172,text,89,551,98,16,29_median.png,1024,1430,187,567
6173,text,267,553,132,16,29_median.png,1024,1430,399,569
6174,text,509,555,50,16,29_median.png,1024,1430,559,571
6175,text,587,555,50,16,29_median.png,1024,1430,637,571
6176,text,693,557,22,14,29_median.png,1024,1430,715,571
6177,text,755,557,28,14,29_median.png,1024,1430,783,571
6178,text,809,557,44,14,29_median.png,1024,1430,853,571
6179,text,901,557,44,16,29_median.png,1024,1430,945,573
6180,text,89,581,96,16,29_median.png,1024,1430,185,597
6181,text,279,583,48,14,29_median.png,1024,1430,327,597
6182,text,326,580,71,20,29_median.png,1024,1430,397,600
6183,text,523,585,36,14,29_median.png,1024,1430,559,599
6184,text,601,585,36,14,29_median.png,1024,1430,637,599
6185,text,693,585,22,14,29_median.png,1024,1430,715,599
6186,text,755,585,28,16,29_median.png,1024,1430,783,601
6187,text,815,585,36,16,29_median.png,1024,1430,851,601
6188,text,915,587,28,14,29_median.png,1024,1430,943,601
6189,text,89,605,42,14,29_median.png,1024,1430,131,619
6190,text,135,605,28,14,29_median.png,1024,1430,163,619
6191,text,899,609,44,16,29_median.png,1024,1430,943,625
6192,text,81,663,84,16,29_median.png,1024,1430,165,679
6193,text,197,661,36,18,29_median.png,1024,1430,233,679
6194,text,129,695,26,16,29_median.png,1024,1430,155,711
6195,text,221,695,66,16,29_median.png,1024,1430,287,711
6196,text,355,697,22,14,29_median.png,1024,1430,377,711
6197,text,471,697,38,16,29_median.png,1024,1430,509,713
6198,text,595,699,28,14,29_median.png,1024,1430,623,713
6199,text,89,719,68,14,29_median.png,1024,1430,157,733
6200,text,259,719,38,16,29_median.png,1024,1430,297,735
6201,text,369,719,52,16,29_median.png,1024,1430,421,735
6202,text,501,721,42,16,29_median.png,1024,1430,543,737
6203,text,607,721,52,16,29_median.png,1024,1430,659,737
6204,text,87,741,44,16,29_median.png,1024,1430,131,757
6205,text,355,743,66,14,29_median.png,1024,1430,421,757
6206,text,487,743,56,16,29_median.png,1024,1430,543,759
6207,text,615,745,42,14,29_median.png,1024,1430,657,759
6208,text,77,799,160,18,29_median.png,1024,1430,237,817
6209,text,163,833,108,16,29_median.png,1024,1430,271,849
6210,text,401,835,42,14,29_median.png,1024,1430,443,849
6211,text,533,835,52,14,29_median.png,1024,1430,585,849
6212,text,87,855,60,14,29_median.png,1024,1430,147,869
6213,text,429,857,54,14,29_median.png,1024,1430,483,871
6214,text,569,857,52,16,29_median.png,1024,1430,621,873
6215,text,856,1318,102,10,29_median.png,1024,1430,958,1328
6216,text,297,1337,416,16,29_median.png,1024,1430,713,1353
6217,text,85,1355,78,16,29_median.png,1024,1430,163,1371
6218,text,169,1353,355,18,29_median.png,1024,1430,524,1371
6219,text,527,1355,66,16,29_median.png,1024,1430,593,1371
6220,text,601,1355,74,16,29_median.png,1024,1430,675,1371
6221,text,681,1355,26,16,29_median.png,1024,1430,707,1371
6222,text,713,1355,94,16,29_median.png,1024,1430,807,1371
6223,text,813,1353,112,18,29_median.png,1024,1430,925,1371
6224,text,255,1373,50,16,29_median.png,1024,1430,305,1389
6225,text,311,1373,34,14,29_median.png,1024,1430,345,1387
6226,text,351,1373,64,16,29_median.png,1024,1430,415,1389
6227,text,423,1373,94,16,29_median.png,1024,1430,517,1389
6228,text,481,1366,36,11,29_median.png,1024,1430,517,1377
6229,text,525,1371,38,18,29_median.png,1024,1430,563,1389
6230,text,569,1373,56,16,29_median.png,1024,1430,625,1389
6231,text,631,1373,148,16,29_median.png,1024,1430,779,1389
6232,text,165,665,33,17,29_median.png,1024,1430,198,682
6233,text,469,552,14,19,29_median.png,1024,1430,483,571
6234,text,469,582,14,19,29_median.png,1024,1430,483,601
6235,text,229,1372,19,18,29_median.png,1024,1430,248,1390
6236,text,69,158,107,27,29_median.png,1024,1430,176,185
6237,text,598,41,354,28,2_contrasted.png,1024,1448,952,69
6238,text,598,102,122,26,2_contrasted.png,1024,1448,720,128
6239,text,600,72,194,26,2_contrasted.png,1024,1448,794,98
6240,text,717,99,149,32,2_contrasted.png,1024,1448,866,131
6241,text,597,125,387,37,2_contrasted.png,1024,1448,984,162
6242,text,64,142,156,42,2_contrasted.png,1024,1448,220,184
6243,text,69,179,150,28,2_contrasted.png,1024,1448,219,207
6244,text,534,210,84,24,2_contrasted.png,1024,1448,618,234
6245,text,531,275,164,20,2_contrasted.png,1024,1448,695,295
6246,text,55,283,157,49,2_contrasted.png,1024,1448,212,332
6247,text,85,365,66,18,2_contrasted.png,1024,1448,151,383
6248,text,201,367,80,18,2_contrasted.png,1024,1448,281,385
6249,text,307,367,98,20,2_contrasted.png,1024,1448,405,387
6250,text,435,369,46,16,2_contrasted.png,1024,1448,481,385
6251,text,547,371,38,16,2_contrasted.png,1024,1448,585,387
6252,text,625,369,158,20,2_contrasted.png,1024,1448,783,389
6253,text,829,371,88,18,2_contrasted.png,1024,1448,917,389
6254,text,81,394,79,26,2_contrasted.png,1024,1448,160,420
6255,text,209,399,64,20,2_contrasted.png,1024,1448,273,419
6256,text,331,401,44,18,2_contrasted.png,1024,1448,375,419
6257,text,69,464,81,27,2_contrasted.png,1024,1448,150,491
6258,text,322,470,94,24,2_contrasted.png,1024,1448,416,494
6259,text,603,473,30,20,2_contrasted.png,1024,1448,633,493
6260,text,691,473,56,20,2_contrasted.png,1024,1448,747,493
6261,text,769,477,58,18,2_contrasted.png,1024,1448,827,495
6262,text,849,475,86,20,2_contrasted.png,1024,1448,935,495
6263,text,70,500,64,24,2_contrasted.png,1024,1448,134,524
6264,text,182,502,302,24,2_contrasted.png,1024,1448,484,526
6265,text,605,507,36,20,2_contrasted.png,1024,1448,641,527
6266,text,719,509,44,20,2_contrasted.png,1024,1448,763,529
6267,text,891,509,52,20,2_contrasted.png,1024,1448,943,529
6268,text,127,1063,112,16,2_contrasted.png,1024,1448,239,1079
6269,text,375,1071,66,20,2_contrasted.png,1024,1448,441,1091
6270,text,503,1071,34,20,2_contrasted.png,1024,1448,537,1091
6271,text,581,1073,98,20,2_contrasted.png,1024,1448,679,1093
6272,text,709,1073,74,20,2_contrasted.png,1024,1448,783,1093
6273,text,815,1075,106,20,2_contrasted.png,1024,1448,921,1095
6274,text,380,1102,54,24,2_contrasted.png,1024,1448,434,1126
6275,text,493,1105,56,20,2_contrasted.png,1024,1448,549,1125
6276,text,607,1107,44,20,2_contrasted.png,1024,1448,651,1127
6277,text,715,1107,52,20,2_contrasted.png,1024,1448,767,1127
6278,text,839,1109,54,20,2_contrasted.png,1024,1448,893,1129
6279,text,48,1220,446,25,2_contrasted.png,1024,1448,494,1245
6280,text,46,1244,348,24,2_contrasted.png,1024,1448,394,1268
6281,text,75,1368,236,21,2_contrasted.png,1024,1448,311,1389
6282,text,324,1368,64,22,2_contrasted.png,1024,1448,388,1390
6283,text,667,1367,267,20,2_contrasted.png,1024,1448,934,1387
6284,text,36,1388,170,24,2_contrasted.png,1024,1448,206,1412
6285,text,214,1386,212,24,2_contrasted.png,1024,1448,426,1410
6286,text,433,1389,146,20,2_contrasted.png,1024,1448,579,1409
6287,text,809,1388,159,22,2_contrasted.png,1024,1448,968,1410
6288,text,395,1367,124,21,2_contrasted.png,1024,1448,519,1388
6289,text,529,1367,129,22,2_contrasted.png,1024,1448,658,1389
6290,text,740,1390,62,19,2_contrasted.png,1024,1448,802,1409
6291,text,664,1388,68,19,2_contrasted.png,1024,1448,732,1407
6292,text,591,1389,60,21,2_contrasted.png,1024,1448,651,1410
6293,text,598,41,354,28,2_denoise.png,1024,1448,952,69
6294,text,598,102,122,26,2_denoise.png,1024,1448,720,128
6295,text,600,72,194,26,2_denoise.png,1024,1448,794,98
6296,text,717,99,149,32,2_denoise.png,1024,1448,866,131
6297,text,597,125,387,37,2_denoise.png,1024,1448,984,162
6298,text,64,142,156,42,2_denoise.png,1024,1448,220,184
6299,text,69,179,150,28,2_denoise.png,1024,1448,219,207
6300,text,534,210,84,24,2_denoise.png,1024,1448,618,234
6301,text,531,275,164,20,2_denoise.png,1024,1448,695,295
6302,text,55,283,157,49,2_denoise.png,1024,1448,212,332
6303,text,85,365,66,18,2_denoise.png,1024,1448,151,383
6304,text,201,367,80,18,2_denoise.png,1024,1448,281,385
6305,text,307,367,98,20,2_denoise.png,1024,1448,405,387
6306,text,435,369,46,16,2_denoise.png,1024,1448,481,385
6307,text,547,371,38,16,2_denoise.png,1024,1448,585,387
6308,text,625,369,158,20,2_denoise.png,1024,1448,783,389
6309,text,829,371,88,18,2_denoise.png,1024,1448,917,389
6310,text,81,394,79,26,2_denoise.png,1024,1448,160,420
6311,text,209,399,64,20,2_denoise.png,1024,1448,273,419
6312,text,331,401,44,18,2_denoise.png,1024,1448,375,419
6313,text,69,464,81,27,2_denoise.png,1024,1448,150,491
6314,text,322,470,94,24,2_denoise.png,1024,1448,416,494
6315,text,603,473,30,20,2_denoise.png,1024,1448,633,493
6316,text,691,473,56,20,2_denoise.png,1024,1448,747,493
6317,text,769,477,58,18,2_denoise.png,1024,1448,827,495
6318,text,849,475,86,20,2_denoise.png,1024,1448,935,495
6319,text,70,500,64,24,2_denoise.png,1024,1448,134,524
6320,text,182,502,302,24,2_denoise.png,1024,1448,484,526
6321,text,605,507,36,20,2_denoise.png,1024,1448,641,527
6322,text,719,509,44,20,2_denoise.png,1024,1448,763,529
6323,text,891,509,52,20,2_denoise.png,1024,1448,943,529
6324,text,127,1063,112,16,2_denoise.png,1024,1448,239,1079
6325,text,375,1071,66,20,2_denoise.png,1024,1448,441,1091
6326,text,503,1071,34,20,2_denoise.png,1024,1448,537,1091
6327,text,581,1073,98,20,2_denoise.png,1024,1448,679,1093
6328,text,709,1073,74,20,2_denoise.png,1024,1448,783,1093
6329,text,815,1075,106,20,2_denoise.png,1024,1448,921,1095
6330,text,380,1102,54,24,2_denoise.png,1024,1448,434,1126
6331,text,493,1105,56,20,2_denoise.png,1024,1448,549,1125
6332,text,607,1107,44,20,2_denoise.png,1024,1448,651,1127
6333,text,715,1107,52,20,2_denoise.png,1024,1448,767,1127
6334,text,839,1109,54,20,2_denoise.png,1024,1448,893,1129
6335,text,48,1220,446,25,2_denoise.png,1024,1448,494,1245
6336,text,46,1244,348,24,2_denoise.png,1024,1448,394,1268
6337,text,75,1368,236,21,2_denoise.png,1024,1448,311,1389
6338,text,324,1368,64,22,2_denoise.png,1024,1448,388,1390
6339,text,667,1367,267,20,2_denoise.png,1024,1448,934,1387
6340,text,36,1388,170,24,2_denoise.png,1024,1448,206,1412
6341,text,214,1386,212,24,2_denoise.png,1024,1448,426,1410
6342,text,433,1389,146,20,2_denoise.png,1024,1448,579,1409
6343,text,809,1388,159,22,2_denoise.png,1024,1448,968,1410
6344,text,395,1367,124,21,2_denoise.png,1024,1448,519,1388
6345,text,529,1367,129,22,2_denoise.png,1024,1448,658,1389
6346,text,740,1390,62,19,2_denoise.png,1024,1448,802,1409
6347,text,664,1388,68,19,2_denoise.png,1024,1448,732,1407
6348,text,591,1389,60,21,2_denoise.png,1024,1448,651,1410
6349,text,598,41,354,28,2_median.png,1024,1448,952,69
6350,text,598,102,122,26,2_median.png,1024,1448,720,128
6351,text,600,72,194,26,2_median.png,1024,1448,794,98
6352,text,717,99,149,32,2_median.png,1024,1448,866,131
6353,text,597,125,387,37,2_median.png,1024,1448,984,162
6354,text,64,142,156,42,2_median.png,1024,1448,220,184
6355,text,69,179,150,28,2_median.png,1024,1448,219,207
6356,text,534,210,84,24,2_median.png,1024,1448,618,234
6357,text,531,275,164,20,2_median.png,1024,1448,695,295
6358,text,55,283,157,49,2_median.png,1024,1448,212,332
6359,text,85,365,66,18,2_median.png,1024,1448,151,383
6360,text,201,367,80,18,2_median.png,1024,1448,281,385
6361,text,307,367,98,20,2_median.png,1024,1448,405,387
6362,text,435,369,46,16,2_median.png,1024,1448,481,385
6363,text,547,371,38,16,2_median.png,1024,1448,585,387
6364,text,625,369,158,20,2_median.png,1024,1448,783,389
6365,text,829,371,88,18,2_median.png,1024,1448,917,389
6366,text,81,394,79,26,2_median.png,1024,1448,160,420
6367,text,209,399,64,20,2_median.png,1024,1448,273,419
6368,text,331,401,44,18,2_median.png,1024,1448,375,419
6369,text,69,464,81,27,2_median.png,1024,1448,150,491
6370,text,322,470,94,24,2_median.png,1024,1448,416,494
6371,text,603,473,30,20,2_median.png,1024,1448,633,493
6372,text,691,473,56,20,2_median.png,1024,1448,747,493
6373,text,769,477,58,18,2_median.png,1024,1448,827,495
6374,text,849,475,86,20,2_median.png,1024,1448,935,495
6375,text,70,500,64,24,2_median.png,1024,1448,134,524
6376,text,182,502,302,24,2_median.png,1024,1448,484,526
6377,text,605,507,36,20,2_median.png,1024,1448,641,527
6378,text,719,509,44,20,2_median.png,1024,1448,763,529
6379,text,891,509,52,20,2_median.png,1024,1448,943,529
6380,text,127,1063,112,16,2_median.png,1024,1448,239,1079
6381,text,375,1071,66,20,2_median.png,1024,1448,441,1091
6382,text,503,1071,34,20,2_median.png,1024,1448,537,1091
6383,text,581,1073,98,20,2_median.png,1024,1448,679,1093
6384,text,709,1073,74,20,2_median.png,1024,1448,783,1093
6385,text,815,1075,106,20,2_median.png,1024,1448,921,1095
6386,text,380,1102,54,24,2_median.png,1024,1448,434,1126
6387,text,493,1105,56,20,2_median.png,1024,1448,549,1125
6388,text,607,1107,44,20,2_median.png,1024,1448,651,1127
6389,text,715,1107,52,20,2_median.png,1024,1448,767,1127
6390,text,839,1109,54,20,2_median.png,1024,1448,893,1129
6391,text,48,1220,446,25,2_median.png,1024,1448,494,1245
6392,text,46,1244,348,24,2_median.png,1024,1448,394,1268
6393,text,75,1368,236,21,2_median.png,1024,1448,311,1389
6394,text,324,1368,64,22,2_median.png,1024,1448,388,1390
6395,text,667,1367,267,20,2_median.png,1024,1448,934,1387
6396,text,36,1388,170,24,2_median.png,1024,1448,206,1412
6397,text,214,1386,212,24,2_median.png,1024,1448,426,1410
6398,text,433,1389,146,20,2_median.png,1024,1448,579,1409
6399,text,809,1388,159,22,2_median.png,1024,1448,968,1410
6400,text,395,1367,124,21,2_median.png,1024,1448,519,1388
6401,text,529,1367,129,22,2_median.png,1024,1448,658,1389
6402,text,740,1390,62,19,2_median.png,1024,1448,802,1409
6403,text,664,1388,68,19,2_median.png,1024,1448,732,1407
6404,text,591,1389,60,21,2_median.png,1024,1448,651,1410
6405,text,129,70,191,57,3.png,1024,1448,320,127
6406,text,642,98,254,32,3.png,1024,1448,896,130
6407,text,737,179,44,20,3.png,1024,1448,781,199
6408,text,716,201,86,24,3.png,1024,1448,802,225
6409,text,709,225,100,18,3.png,1024,1448,809,243
6410,text,683,247,150,18,3.png,1024,1448,833,265
6411,text,711,269,44,16,3.png,1024,1448,755,285
6412,text,765,271,38,14,3.png,1024,1448,803,285
6413,text,133,305,72,18,3.png,1024,1448,205,323
6414,text,233,305,134,20,3.png,1024,1448,367,325
6415,text,135,329,34,16,3.png,1024,1448,169,345
6416,text,235,329,206,20,3.png,1024,1448,441,349
6417,text,135,351,70,16,3.png,1024,1448,205,367
6418,text,233,348,126,20,3.png,1024,1448,359,368
6419,text,133,373,56,16,3.png,1024,1448,189,389
6420,text,233,371,74,20,3.png,1024,1448,307,391
6421,text,245,483,82,18,3.png,1024,1448,327,501
6422,text,463,483,38,20,3.png,1024,1448,501,503
6423,text,533,485,62,16,3.png,1024,1448,595,501
6424,text,643,483,62,20,3.png,1024,1448,705,503
6425,text,787,485,74,20,3.png,1024,1448,861,505
6426,text,156,523,259,20,3.png,1024,1448,415,543
6427,text,461,525,43,24,3.png,1024,1448,504,549
6428,text,539,525,42,16,3.png,1024,1448,581,541
6429,text,677,527,68,16,3.png,1024,1448,745,543
6430,text,829,527,72,18,3.png,1024,1448,901,545
6431,text,613,765,112,20,3.png,1024,1448,725,785
6432,text,827,769,70,16,3.png,1024,1448,897,785
6433,text,613,787,110,20,3.png,1024,1448,723,807
6434,text,825,789,72,20,3.png,1024,1448,897,809
6435,text,607,805,121,25,3.png,1024,1448,728,830
6436,text,827,811,70,18,3.png,1024,1448,897,829
6437,text,123,871,284,20,3.png,1024,1448,407,891
6438,text,255,895,340,18,3.png,1024,1448,595,913
6439,text,199,976,151,27,3.png,1024,1448,350,1003
6440,text,193,1003,228,18,3.png,1024,1448,421,1021
6441,text,173,1027,126,16,3.png,1024,1448,299,1043
6442,text,449,1294,104,13,3.png,1024,1448,553,1307
6443,text,315,1307,295,14,3.png,1024,1448,610,1321
6444,text,613,1309,74,14,3.png,1024,1448,687,1323
6445,text,369,1319,22,14,3.png,1024,1448,391,1333
6446,text,395,1319,100,14,3.png,1024,1448,495,1333
6447,text,523,1321,34,12,3.png,1024,1448,557,1333
6448,text,563,1321,68,14,3.png,1024,1448,631,1335
6449,text,204,1090,137,19,3.png,1024,1448,341,1109
6450,text,114,1221,181,17,3.png,1024,1448,295,1238
6451,text,499,1321,19,12,3.png,1024,1448,518,1333
6452,text,321,71,62,20,30.png,1024,1430,383,91
6453,text,72,112,202,24,30.png,1024,1430,274,136
6454,text,280,110,92,24,30.png,1024,1430,372,134
6455,text,54,131,221,25,30.png,1024,1430,275,156
6456,text,283,133,106,20,30.png,1024,1430,389,153
6457,text,317,162,409,26,30.png,1024,1430,726,188
6458,text,76,248,61,14,30.png,1024,1430,137,262
6459,text,177,249,46,14,30.png,1024,1430,223,263
6460,text,256,246,49,17,30.png,1024,1430,305,263
6461,text,345,249,52,12,30.png,1024,1430,397,261
6462,text,608,236,156,24,30.png,1024,1430,764,260
6463,text,65,261,86,14,30.png,1024,1430,151,275
6464,text,190,264,24,6,30.png,1024,1430,214,270
6465,text,261,261,40,12,30.png,1024,1430,301,273
6466,text,357,261,38,14,30.png,1024,1430,395,275
6467,text,606,262,188,24,30.png,1024,1430,794,286
6468,text,607,285,107,26,30.png,1024,1430,714,311
6469,text,85,321,44,12,30.png,1024,1430,129,333
6470,text,179,319,40,14,30.png,1024,1430,219,333
6471,text,253,319,54,14,30.png,1024,1430,307,333
6472,text,339,319,62,14,30.png,1024,1430,401,333
6473,text,606,308,184,27,30.png,1024,1430,790,335
6474,text,78,332,57,14,30.png,1024,1430,135,346
6475,text,167,331,64,14,30.png,1024,1430,231,345
6476,text,251,331,58,14,30.png,1024,1430,309,345
6477,text,343,331,54,12,30.png,1024,1430,397,343
6478,text,86,344,43,16,30.png,1024,1430,129,360
6479,text,257,345,46,14,30.png,1024,1430,303,359
6480,text,339,343,60,12,30.png,1024,1430,399,355
6481,text,88,410,55,20,30.png,1024,1430,143,430
6482,text,233,413,44,20,30.png,1024,1430,277,433
6483,text,323,415,112,16,30.png,1024,1430,435,431
6484,text,493,411,82,18,30.png,1024,1430,575,429
6485,text,669,413,64,16,30.png,1024,1430,733,429
6486,text,813,415,116,16,30.png,1024,1430,929,431
6487,text,661,441,108,18,30.png,1024,1430,769,459
6488,text,73,455,82,20,30.png,1024,1430,155,475
6489,text,205,453,64,20,30.png,1024,1430,269,473
6490,text,497,453,88,16,30.png,1024,1430,585,469
6491,text,673,457,92,16,30.png,1024,1430,765,473
6492,text,323,551,108,20,30.png,1024,1430,431,571
6493,text,543,551,60,16,30.png,1024,1430,603,567
6494,text,645,551,52,18,30.png,1024,1430,697,569
6495,text,713,551,54,16,30.png,1024,1430,767,567
6496,text,777,547,74,20,30.png,1024,1430,851,567
6497,text,859,545,80,20,30.png,1024,1430,939,565
6498,text,91,559,86,16,30.png,1024,1430,177,575
6499,text,79,599,64,16,30.png,1024,1430,143,615
6500,text,197,595,216,20,30.png,1024,1430,413,615
6501,text,575,597,40,18,30.png,1024,1430,615,615
6502,text,663,597,42,16,30.png,1024,1430,705,613
6503,text,783,595,42,16,30.png,1024,1430,825,611
6504,text,893,593,50,18,30.png,1024,1430,943,611
6505,text,75,619,90,18,30.png,1024,1430,165,637
6506,text,197,617,240,20,30.png,1024,1430,437,637
6507,text,573,617,42,20,30.png,1024,1430,615,637
6508,text,663,615,42,20,30.png,1024,1430,705,635
6509,text,779,613,46,20,30.png,1024,1430,825,633
6510,text,893,613,52,20,30.png,1024,1430,945,633
6511,text,197,635,176,18,30.png,1024,1430,373,653
6512,text,77,659,42,16,30.png,1024,1430,119,675
6513,text,197,655,280,20,30.png,1024,1430,477,675
6514,text,573,655,42,20,30.png,1024,1430,615,675
6515,text,653,655,52,18,30.png,1024,1430,705,673
6516,text,781,653,52,18,30.png,1024,1430,833,671
6517,text,895,655,48,16,30.png,1024,1430,943,671
6518,text,197,673,104,20,30.png,1024,1430,301,693
6519,text,75,695,50,20,30.png,1024,1430,125,715
6520,text,196,692,298,24,30.png,1024,1430,494,716
6521,text,565,693,50,20,30.png,1024,1430,615,713
6522,text,661,693,44,18,30.png,1024,1430,705,711
6523,text,781,691,42,18,30.png,1024,1430,823,709
6524,text,903,693,40,16,30.png,1024,1430,943,709
6525,text,199,712,124,17,30.png,1024,1430,323,729
6526,text,61,1105,26,18,30.png,1024,1430,87,1123
6527,text,525,1101,76,20,30.png,1024,1430,601,1121
6528,text,719,1101,62,18,30.png,1024,1430,781,1119
6529,text,529,1133,32,14,30.png,1024,1430,561,1147
6530,text,559,1129,36,20,30.png,1024,1430,595,1149
6531,text,719,1135,48,16,30.png,1024,1430,767,1151
6532,text,527,1159,86,20,30.png,1024,1430,613,1179
6533,text,721,1163,62,18,30.png,1024,1430,783,1181
6534,text,527,1189,181,20,30.png,1024,1430,708,1209
6535,text,717,1187,66,20,30.png,1024,1430,783,1207
6536,text,47,1209,146,18,30.png,1024,1430,193,1227
6537,text,197,1209,110,18,30.png,1024,1430,307,1227
6538,text,43,1227,274,21,30.png,1024,1430,317,1248
6539,text,42,1248,600,24,30.png,1024,1430,642,1272
6540,text,43,1271,468,20,30.png,1024,1430,511,1291
6541,text,761,1277,76,21,30.png,1024,1430,837,1298
6542,text,93,1331,98,16,30.png,1024,1430,191,1347
6543,text,195,1331,70,14,30.png,1024,1430,265,1345
6544,text,277,1329,80,16,30.png,1024,1430,357,1345
6545,text,533,1335,70,16,30.png,1024,1430,603,1351
6546,text,609,1333,82,16,30.png,1024,1430,691,1349
6547,text,705,1333,60,16,30.png,1024,1430,765,1349
6548,text,771,1327,198,20,30.png,1024,1430,969,1347
6549,text,63,1347,28,14,30.png,1024,1430,91,1361
6550,text,101,1345,118,16,30.png,1024,1430,219,1361
6551,text,229,1345,98,16,30.png,1024,1430,327,1361
6552,text,335,1345,30,14,30.png,1024,1430,365,1359
6553,text,373,1343,98,16,30.png,1024,1430,471,1359
6554,text,533,1353,100,16,30.png,1024,1430,633,1369
6555,text,645,1351,108,16,30.png,1024,1430,753,1367
6556,text,765,1351,48,14,30.png,1024,1430,813,1365
6557,text,823,1349,148,16,30.png,1024,1430,971,1365
6558,text,63,1363,32,14,30.png,1024,1430,95,1377
6559,text,105,1361,102,14,30.png,1024,1430,207,1375
6560,text,221,1361,50,14,30.png,1024,1430,271,1375
6561,text,289,1359,44,16,30.png,1024,1430,333,1375
6562,text,341,1359,68,16,30.png,1024,1430,409,1375
6563,text,854,1365,117,19,30.png,1024,1430,971,1384
6564,text,63,1377,54,14,30.png,1024,1430,117,1391
6565,text,127,1375,98,16,30.png,1024,1430,225,1391
6566,text,235,1375,120,14,30.png,1024,1430,355,1389
6567,text,365,1373,44,16,30.png,1024,1430,409,1389
6568,text,419,1373,36,16,30.png,1024,1430,455,1389
6569,text,463,1373,32,14,30.png,1024,1430,495,1387
6570,text,533,1371,64,16,30.png,1024,1430,597,1387
6571,text,609,1371,116,14,30.png,1024,1430,725,1385
6572,text,749,1369,104,14,30.png,1024,1430,853,1383
6573,text,39,548,22,25,30.png,1024,1430,61,573
6574,text,34,595,16,23,30.png,1024,1430,50,618
6575,text,33,616,17,22,30.png,1024,1430,50,638
6576,text,30,655,19,23,30.png,1024,1430,49,678
6577,text,32,692,17,26,30.png,1024,1430,49,718
6578,text,41,1287,169,18,30.png,1024,1430,210,1305
6579,text,63,1329,17,16,30.png,1024,1430,80,1345
6580,text,321,71,62,20,30_contrasted.png,1024,1430,383,91
6581,text,72,112,202,24,30_contrasted.png,1024,1430,274,136
6582,text,280,110,92,24,30_contrasted.png,1024,1430,372,134
6583,text,54,131,221,25,30_contrasted.png,1024,1430,275,156
6584,text,283,133,106,20,30_contrasted.png,1024,1430,389,153
6585,text,317,162,409,26,30_contrasted.png,1024,1430,726,188
6586,text,76,248,61,14,30_contrasted.png,1024,1430,137,262
6587,text,177,249,46,14,30_contrasted.png,1024,1430,223,263
6588,text,256,246,49,17,30_contrasted.png,1024,1430,305,263
6589,text,345,249,52,12,30_contrasted.png,1024,1430,397,261
6590,text,608,236,156,24,30_contrasted.png,1024,1430,764,260
6591,text,65,261,86,14,30_contrasted.png,1024,1430,151,275
6592,text,190,264,24,6,30_contrasted.png,1024,1430,214,270
6593,text,261,261,40,12,30_contrasted.png,1024,1430,301,273
6594,text,357,261,38,14,30_contrasted.png,1024,1430,395,275
6595,text,606,262,188,24,30_contrasted.png,1024,1430,794,286
6596,text,607,285,107,26,30_contrasted.png,1024,1430,714,311
6597,text,85,321,44,12,30_contrasted.png,1024,1430,129,333
6598,text,179,319,40,14,30_contrasted.png,1024,1430,219,333
6599,text,253,319,54,14,30_contrasted.png,1024,1430,307,333
6600,text,339,319,62,14,30_contrasted.png,1024,1430,401,333
6601,text,606,308,184,27,30_contrasted.png,1024,1430,790,335
6602,text,78,332,57,14,30_contrasted.png,1024,1430,135,346
6603,text,167,331,64,14,30_contrasted.png,1024,1430,231,345
6604,text,251,331,58,14,30_contrasted.png,1024,1430,309,345
6605,text,343,331,54,12,30_contrasted.png,1024,1430,397,343
6606,text,86,344,43,16,30_contrasted.png,1024,1430,129,360
6607,text,257,345,46,14,30_contrasted.png,1024,1430,303,359
6608,text,339,343,60,12,30_contrasted.png,1024,1430,399,355
6609,text,88,410,55,20,30_contrasted.png,1024,1430,143,430
6610,text,233,413,44,20,30_contrasted.png,1024,1430,277,433
6611,text,323,415,112,16,30_contrasted.png,1024,1430,435,431
6612,text,493,411,82,18,30_contrasted.png,1024,1430,575,429
6613,text,669,413,64,16,30_contrasted.png,1024,1430,733,429
6614,text,813,415,116,16,30_contrasted.png,1024,1430,929,431
6615,text,661,441,108,18,30_contrasted.png,1024,1430,769,459
6616,text,73,455,82,20,30_contrasted.png,1024,1430,155,475
6617,text,205,453,64,20,30_contrasted.png,1024,1430,269,473
6618,text,497,453,88,16,30_contrasted.png,1024,1430,585,469
6619,text,673,457,92,16,30_contrasted.png,1024,1430,765,473
6620,text,323,551,108,20,30_contrasted.png,1024,1430,431,571
6621,text,543,551,60,16,30_contrasted.png,1024,1430,603,567
6622,text,645,551,52,18,30_contrasted.png,1024,1430,697,569
6623,text,713,551,54,16,30_contrasted.png,1024,1430,767,567
6624,text,777,547,74,20,30_contrasted.png,1024,1430,851,567
6625,text,859,545,80,20,30_contrasted.png,1024,1430,939,565
6626,text,91,559,86,16,30_contrasted.png,1024,1430,177,575
6627,text,79,599,64,16,30_contrasted.png,1024,1430,143,615
6628,text,197,595,216,20,30_contrasted.png,1024,1430,413,615
6629,text,575,597,40,18,30_contrasted.png,1024,1430,615,615
6630,text,663,597,42,16,30_contrasted.png,1024,1430,705,613
6631,text,783,595,42,16,30_contrasted.png,1024,1430,825,611
6632,text,893,593,50,18,30_contrasted.png,1024,1430,943,611
6633,text,75,619,90,18,30_contrasted.png,1024,1430,165,637
6634,text,197,617,240,20,30_contrasted.png,1024,1430,437,637
6635,text,573,617,42,20,30_contrasted.png,1024,1430,615,637
6636,text,663,615,42,20,30_contrasted.png,1024,1430,705,635
6637,text,779,613,46,20,30_contrasted.png,1024,1430,825,633
6638,text,893,613,52,20,30_contrasted.png,1024,1430,945,633
6639,text,197,635,176,18,30_contrasted.png,1024,1430,373,653
6640,text,77,659,42,16,30_contrasted.png,1024,1430,119,675
6641,text,197,655,280,20,30_contrasted.png,1024,1430,477,675
6642,text,573,655,42,20,30_contrasted.png,1024,1430,615,675
6643,text,653,655,52,18,30_contrasted.png,1024,1430,705,673
6644,text,781,653,52,18,30_contrasted.png,1024,1430,833,671
6645,text,895,655,48,16,30_contrasted.png,1024,1430,943,671
6646,text,197,673,104,20,30_contrasted.png,1024,1430,301,693
6647,text,75,695,50,20,30_contrasted.png,1024,1430,125,715
6648,text,196,692,298,24,30_contrasted.png,1024,1430,494,716
6649,text,565,693,50,20,30_contrasted.png,1024,1430,615,713
6650,text,661,693,44,18,30_contrasted.png,1024,1430,705,711
6651,text,781,691,42,18,30_contrasted.png,1024,1430,823,709
6652,text,903,693,40,16,30_contrasted.png,1024,1430,943,709
6653,text,199,712,124,17,30_contrasted.png,1024,1430,323,729
6654,text,61,1105,26,18,30_contrasted.png,1024,1430,87,1123
6655,text,525,1101,76,20,30_contrasted.png,1024,1430,601,1121
6656,text,719,1101,62,18,30_contrasted.png,1024,1430,781,1119
6657,text,529,1133,32,14,30_contrasted.png,1024,1430,561,1147
6658,text,559,1129,36,20,30_contrasted.png,1024,1430,595,1149
6659,text,719,1135,48,16,30_contrasted.png,1024,1430,767,1151
6660,text,527,1159,86,20,30_contrasted.png,1024,1430,613,1179
6661,text,721,1163,62,18,30_contrasted.png,1024,1430,783,1181
6662,text,527,1189,181,20,30_contrasted.png,1024,1430,708,1209
6663,text,717,1187,66,20,30_contrasted.png,1024,1430,783,1207
6664,text,47,1209,146,18,30_contrasted.png,1024,1430,193,1227
6665,text,197,1209,110,18,30_contrasted.png,1024,1430,307,1227
6666,text,43,1227,274,21,30_contrasted.png,1024,1430,317,1248
6667,text,42,1248,600,24,30_contrasted.png,1024,1430,642,1272
6668,text,43,1271,468,20,30_contrasted.png,1024,1430,511,1291
6669,text,761,1277,76,21,30_contrasted.png,1024,1430,837,1298
6670,text,93,1331,98,16,30_contrasted.png,1024,1430,191,1347
6671,text,195,1331,70,14,30_contrasted.png,1024,1430,265,1345
6672,text,277,1329,80,16,30_contrasted.png,1024,1430,357,1345
6673,text,533,1335,70,16,30_contrasted.png,1024,1430,603,1351
6674,text,609,1333,82,16,30_contrasted.png,1024,1430,691,1349
6675,text,705,1333,60,16,30_contrasted.png,1024,1430,765,1349
6676,text,771,1327,198,20,30_contrasted.png,1024,1430,969,1347
6677,text,63,1347,28,14,30_contrasted.png,1024,1430,91,1361
6678,text,101,1345,118,16,30_contrasted.png,1024,1430,219,1361
6679,text,229,1345,98,16,30_contrasted.png,1024,1430,327,1361
6680,text,335,1345,30,14,30_contrasted.png,1024,1430,365,1359
6681,text,373,1343,98,16,30_contrasted.png,1024,1430,471,1359
6682,text,533,1353,100,16,30_contrasted.png,1024,1430,633,1369
6683,text,645,1351,108,16,30_contrasted.png,1024,1430,753,1367
6684,text,765,1351,48,14,30_contrasted.png,1024,1430,813,1365
6685,text,823,1349,148,16,30_contrasted.png,1024,1430,971,1365
6686,text,63,1363,32,14,30_contrasted.png,1024,1430,95,1377
6687,text,105,1361,102,14,30_contrasted.png,1024,1430,207,1375
6688,text,221,1361,50,14,30_contrasted.png,1024,1430,271,1375
6689,text,289,1359,44,16,30_contrasted.png,1024,1430,333,1375
6690,text,341,1359,68,16,30_contrasted.png,1024,1430,409,1375
6691,text,854,1365,117,19,30_contrasted.png,1024,1430,971,1384
6692,text,63,1377,54,14,30_contrasted.png,1024,1430,117,1391
6693,text,127,1375,98,16,30_contrasted.png,1024,1430,225,1391
6694,text,235,1375,120,14,30_contrasted.png,1024,1430,355,1389
6695,text,365,1373,44,16,30_contrasted.png,1024,1430,409,1389
6696,text,419,1373,36,16,30_contrasted.png,1024,1430,455,1389
6697,text,463,1373,32,14,30_contrasted.png,1024,1430,495,1387
6698,text,533,1371,64,16,30_contrasted.png,1024,1430,597,1387
6699,text,609,1371,116,14,30_contrasted.png,1024,1430,725,1385
6700,text,749,1369,104,14,30_contrasted.png,1024,1430,853,1383
6701,text,39,548,22,25,30_contrasted.png,1024,1430,61,573
6702,text,34,595,16,23,30_contrasted.png,1024,1430,50,618
6703,text,33,616,17,22,30_contrasted.png,1024,1430,50,638
6704,text,30,655,19,23,30_contrasted.png,1024,1430,49,678
6705,text,32,692,17,26,30_contrasted.png,1024,1430,49,718
6706,text,41,1287,169,18,30_contrasted.png,1024,1430,210,1305
6707,text,63,1329,17,16,30_contrasted.png,1024,1430,80,1345
6708,text,321,71,62,20,30_denoise.png,1024,1430,383,91
6709,text,72,112,202,24,30_denoise.png,1024,1430,274,136
6710,text,280,110,92,24,30_denoise.png,1024,1430,372,134
6711,text,54,131,221,25,30_denoise.png,1024,1430,275,156
6712,text,283,133,106,20,30_denoise.png,1024,1430,389,153
6713,text,317,162,409,26,30_denoise.png,1024,1430,726,188
6714,text,76,248,61,14,30_denoise.png,1024,1430,137,262
6715,text,177,249,46,14,30_denoise.png,1024,1430,223,263
6716,text,256,246,49,17,30_denoise.png,1024,1430,305,263
6717,text,345,249,52,12,30_denoise.png,1024,1430,397,261
6718,text,608,236,156,24,30_denoise.png,1024,1430,764,260
6719,text,65,261,86,14,30_denoise.png,1024,1430,151,275
6720,text,190,264,24,6,30_denoise.png,1024,1430,214,270
6721,text,261,261,40,12,30_denoise.png,1024,1430,301,273
6722,text,357,261,38,14,30_denoise.png,1024,1430,395,275
6723,text,606,262,188,24,30_denoise.png,1024,1430,794,286
6724,text,607,285,107,26,30_denoise.png,1024,1430,714,311
6725,text,85,321,44,12,30_denoise.png,1024,1430,129,333
6726,text,179,319,40,14,30_denoise.png,1024,1430,219,333
6727,text,253,319,54,14,30_denoise.png,1024,1430,307,333
6728,text,339,319,62,14,30_denoise.png,1024,1430,401,333
6729,text,606,308,184,27,30_denoise.png,1024,1430,790,335
6730,text,78,332,57,14,30_denoise.png,1024,1430,135,346
6731,text,167,331,64,14,30_denoise.png,1024,1430,231,345
6732,text,251,331,58,14,30_denoise.png,1024,1430,309,345
6733,text,343,331,54,12,30_denoise.png,1024,1430,397,343
6734,text,86,344,43,16,30_denoise.png,1024,1430,129,360
6735,text,257,345,46,14,30_denoise.png,1024,1430,303,359
6736,text,339,343,60,12,30_denoise.png,1024,1430,399,355
6737,text,88,410,55,20,30_denoise.png,1024,1430,143,430
6738,text,233,413,44,20,30_denoise.png,1024,1430,277,433
6739,text,323,415,112,16,30_denoise.png,1024,1430,435,431
6740,text,493,411,82,18,30_denoise.png,1024,1430,575,429
6741,text,669,413,64,16,30_denoise.png,1024,1430,733,429
6742,text,813,415,116,16,30_denoise.png,1024,1430,929,431
6743,text,661,441,108,18,30_denoise.png,1024,1430,769,459
6744,text,73,455,82,20,30_denoise.png,1024,1430,155,475
6745,text,205,453,64,20,30_denoise.png,1024,1430,269,473
6746,text,497,453,88,16,30_denoise.png,1024,1430,585,469
6747,text,673,457,92,16,30_denoise.png,1024,1430,765,473
6748,text,323,551,108,20,30_denoise.png,1024,1430,431,571
6749,text,543,551,60,16,30_denoise.png,1024,1430,603,567
6750,text,645,551,52,18,30_denoise.png,1024,1430,697,569
6751,text,713,551,54,16,30_denoise.png,1024,1430,767,567
6752,text,777,547,74,20,30_denoise.png,1024,1430,851,567
6753,text,859,545,80,20,30_denoise.png,1024,1430,939,565
6754,text,91,559,86,16,30_denoise.png,1024,1430,177,575
6755,text,79,599,64,16,30_denoise.png,1024,1430,143,615
6756,text,197,595,216,20,30_denoise.png,1024,1430,413,615
6757,text,575,597,40,18,30_denoise.png,1024,1430,615,615
6758,text,663,597,42,16,30_denoise.png,1024,1430,705,613
6759,text,783,595,42,16,30_denoise.png,1024,1430,825,611
6760,text,893,593,50,18,30_denoise.png,1024,1430,943,611
6761,text,75,619,90,18,30_denoise.png,1024,1430,165,637
6762,text,197,617,240,20,30_denoise.png,1024,1430,437,637
6763,text,573,617,42,20,30_denoise.png,1024,1430,615,637
6764,text,663,615,42,20,30_denoise.png,1024,1430,705,635
6765,text,779,613,46,20,30_denoise.png,1024,1430,825,633
6766,text,893,613,52,20,30_denoise.png,1024,1430,945,633
6767,text,197,635,176,18,30_denoise.png,1024,1430,373,653
6768,text,77,659,42,16,30_denoise.png,1024,1430,119,675
6769,text,197,655,280,20,30_denoise.png,1024,1430,477,675
6770,text,573,655,42,20,30_denoise.png,1024,1430,615,675
6771,text,653,655,52,18,30_denoise.png,1024,1430,705,673
6772,text,781,653,52,18,30_denoise.png,1024,1430,833,671
6773,text,895,655,48,16,30_denoise.png,1024,1430,943,671
6774,text,197,673,104,20,30_denoise.png,1024,1430,301,693
6775,text,75,695,50,20,30_denoise.png,1024,1430,125,715
6776,text,196,692,298,24,30_denoise.png,1024,1430,494,716
6777,text,565,693,50,20,30_denoise.png,1024,1430,615,713
6778,text,661,693,44,18,30_denoise.png,1024,1430,705,711
6779,text,781,691,42,18,30_denoise.png,1024,1430,823,709
6780,text,903,693,40,16,30_denoise.png,1024,1430,943,709
6781,text,199,712,124,17,30_denoise.png,1024,1430,323,729
6782,text,61,1105,26,18,30_denoise.png,1024,1430,87,1123
6783,text,525,1101,76,20,30_denoise.png,1024,1430,601,1121
6784,text,719,1101,62,18,30_denoise.png,1024,1430,781,1119
6785,text,529,1133,32,14,30_denoise.png,1024,1430,561,1147
6786,text,559,1129,36,20,30_denoise.png,1024,1430,595,1149
6787,text,719,1135,48,16,30_denoise.png,1024,1430,767,1151
6788,text,527,1159,86,20,30_denoise.png,1024,1430,613,1179
6789,text,721,1163,62,18,30_denoise.png,1024,1430,783,1181
6790,text,527,1189,181,20,30_denoise.png,1024,1430,708,1209
6791,text,717,1187,66,20,30_denoise.png,1024,1430,783,1207
6792,text,47,1209,146,18,30_denoise.png,1024,1430,193,1227
6793,text,197,1209,110,18,30_denoise.png,1024,1430,307,1227
6794,text,43,1227,274,21,30_denoise.png,1024,1430,317,1248
6795,text,42,1248,600,24,30_denoise.png,1024,1430,642,1272
6796,text,43,1271,468,20,30_denoise.png,1024,1430,511,1291
6797,text,761,1277,76,21,30_denoise.png,1024,1430,837,1298
6798,text,93,1331,98,16,30_denoise.png,1024,1430,191,1347
6799,text,195,1331,70,14,30_denoise.png,1024,1430,265,1345
6800,text,277,1329,80,16,30_denoise.png,1024,1430,357,1345
6801,text,533,1335,70,16,30_denoise.png,1024,1430,603,1351
6802,text,609,1333,82,16,30_denoise.png,1024,1430,691,1349
6803,text,705,1333,60,16,30_denoise.png,1024,1430,765,1349
6804,text,771,1327,198,20,30_denoise.png,1024,1430,969,1347
6805,text,63,1347,28,14,30_denoise.png,1024,1430,91,1361
6806,text,101,1345,118,16,30_denoise.png,1024,1430,219,1361
6807,text,229,1345,98,16,30_denoise.png,1024,1430,327,1361
6808,text,335,1345,30,14,30_denoise.png,1024,1430,365,1359
6809,text,373,1343,98,16,30_denoise.png,1024,1430,471,1359
6810,text,533,1353,100,16,30_denoise.png,1024,1430,633,1369
6811,text,645,1351,108,16,30_denoise.png,1024,1430,753,1367
6812,text,765,1351,48,14,30_denoise.png,1024,1430,813,1365
6813,text,823,1349,148,16,30_denoise.png,1024,1430,971,1365
6814,text,63,1363,32,14,30_denoise.png,1024,1430,95,1377
6815,text,105,1361,102,14,30_denoise.png,1024,1430,207,1375
6816,text,221,1361,50,14,30_denoise.png,1024,1430,271,1375
6817,text,289,1359,44,16,30_denoise.png,1024,1430,333,1375
6818,text,341,1359,68,16,30_denoise.png,1024,1430,409,1375
6819,text,854,1365,117,19,30_denoise.png,1024,1430,971,1384
6820,text,63,1377,54,14,30_denoise.png,1024,1430,117,1391
6821,text,127,1375,98,16,30_denoise.png,1024,1430,225,1391
6822,text,235,1375,120,14,30_denoise.png,1024,1430,355,1389
6823,text,365,1373,44,16,30_denoise.png,1024,1430,409,1389
6824,text,419,1373,36,16,30_denoise.png,1024,1430,455,1389
6825,text,463,1373,32,14,30_denoise.png,1024,1430,495,1387
6826,text,533,1371,64,16,30_denoise.png,1024,1430,597,1387
6827,text,609,1371,116,14,30_denoise.png,1024,1430,725,1385
6828,text,749,1369,104,14,30_denoise.png,1024,1430,853,1383
6829,text,39,548,22,25,30_denoise.png,1024,1430,61,573
6830,text,34,595,16,23,30_denoise.png,1024,1430,50,618
6831,text,33,616,17,22,30_denoise.png,1024,1430,50,638
6832,text,30,655,19,23,30_denoise.png,1024,1430,49,678
6833,text,32,692,17,26,30_denoise.png,1024,1430,49,718
6834,text,41,1287,169,18,30_denoise.png,1024,1430,210,1305
6835,text,63,1329,17,16,30_denoise.png,1024,1430,80,1345
6836,text,321,71,62,20,30_median.png,1024,1430,383,91
6837,text,72,112,202,24,30_median.png,1024,1430,274,136
6838,text,280,110,92,24,30_median.png,1024,1430,372,134
6839,text,54,131,221,25,30_median.png,1024,1430,275,156
6840,text,283,133,106,20,30_median.png,1024,1430,389,153
6841,text,317,162,409,26,30_median.png,1024,1430,726,188
6842,text,76,248,61,14,30_median.png,1024,1430,137,262
6843,text,177,249,46,14,30_median.png,1024,1430,223,263
6844,text,256,246,49,17,30_median.png,1024,1430,305,263
6845,text,345,249,52,12,30_median.png,1024,1430,397,261
6846,text,608,236,156,24,30_median.png,1024,1430,764,260
6847,text,65,261,86,14,30_median.png,1024,1430,151,275
6848,text,190,264,24,6,30_median.png,1024,1430,214,270
6849,text,261,261,40,12,30_median.png,1024,1430,301,273
6850,text,357,261,38,14,30_median.png,1024,1430,395,275
6851,text,606,262,188,24,30_median.png,1024,1430,794,286
6852,text,607,285,107,26,30_median.png,1024,1430,714,311
6853,text,85,321,44,12,30_median.png,1024,1430,129,333
6854,text,179,319,40,14,30_median.png,1024,1430,219,333
6855,text,253,319,54,14,30_median.png,1024,1430,307,333
6856,text,339,319,62,14,30_median.png,1024,1430,401,333
6857,text,606,308,184,27,30_median.png,1024,1430,790,335
6858,text,78,332,57,14,30_median.png,1024,1430,135,346
6859,text,167,331,64,14,30_median.png,1024,1430,231,345
6860,text,251,331,58,14,30_median.png,1024,1430,309,345
6861,text,343,331,54,12,30_median.png,1024,1430,397,343
6862,text,86,344,43,16,30_median.png,1024,1430,129,360
6863,text,257,345,46,14,30_median.png,1024,1430,303,359
6864,text,339,343,60,12,30_median.png,1024,1430,399,355
6865,text,88,410,55,20,30_median.png,1024,1430,143,430
6866,text,233,413,44,20,30_median.png,1024,1430,277,433
6867,text,323,415,112,16,30_median.png,1024,1430,435,431
6868,text,493,411,82,18,30_median.png,1024,1430,575,429
6869,text,669,413,64,16,30_median.png,1024,1430,733,429
6870,text,813,415,116,16,30_median.png,1024,1430,929,431
6871,text,661,441,108,18,30_median.png,1024,1430,769,459
6872,text,73,455,82,20,30_median.png,1024,1430,155,475
6873,text,205,453,64,20,30_median.png,1024,1430,269,473
6874,text,497,453,88,16,30_median.png,1024,1430,585,469
6875,text,673,457,92,16,30_median.png,1024,1430,765,473
6876,text,323,551,108,20,30_median.png,1024,1430,431,571
6877,text,543,551,60,16,30_median.png,1024,1430,603,567
6878,text,645,551,52,18,30_median.png,1024,1430,697,569
6879,text,713,551,54,16,30_median.png,1024,1430,767,567
6880,text,777,547,74,20,30_median.png,1024,1430,851,567
6881,text,859,545,80,20,30_median.png,1024,1430,939,565
6882,text,91,559,86,16,30_median.png,1024,1430,177,575
6883,text,79,599,64,16,30_median.png,1024,1430,143,615
6884,text,197,595,216,20,30_median.png,1024,1430,413,615
6885,text,575,597,40,18,30_median.png,1024,1430,615,615
6886,text,663,597,42,16,30_median.png,1024,1430,705,613
6887,text,783,595,42,16,30_median.png,1024,1430,825,611
6888,text,893,593,50,18,30_median.png,1024,1430,943,611
6889,text,75,619,90,18,30_median.png,1024,1430,165,637
6890,text,197,617,240,20,30_median.png,1024,1430,437,637
6891,text,573,617,42,20,30_median.png,1024,1430,615,637
6892,text,663,615,42,20,30_median.png,1024,1430,705,635
6893,text,779,613,46,20,30_median.png,1024,1430,825,633
6894,text,893,613,52,20,30_median.png,1024,1430,945,633
6895,text,197,635,176,18,30_median.png,1024,1430,373,653
6896,text,77,659,42,16,30_median.png,1024,1430,119,675
6897,text,197,655,280,20,30_median.png,1024,1430,477,675
6898,text,573,655,42,20,30_median.png,1024,1430,615,675
6899,text,653,655,52,18,30_median.png,1024,1430,705,673
6900,text,781,653,52,18,30_median.png,1024,1430,833,671
6901,text,895,655,48,16,30_median.png,1024,1430,943,671
6902,text,197,673,104,20,30_median.png,1024,1430,301,693
6903,text,75,695,50,20,30_median.png,1024,1430,125,715
6904,text,196,692,298,24,30_median.png,1024,1430,494,716
6905,text,565,693,50,20,30_median.png,1024,1430,615,713
6906,text,661,693,44,18,30_median.png,1024,1430,705,711
6907,text,781,691,42,18,30_median.png,1024,1430,823,709
6908,text,903,693,40,16,30_median.png,1024,1430,943,709
6909,text,199,712,124,17,30_median.png,1024,1430,323,729
6910,text,61,1105,26,18,30_median.png,1024,1430,87,1123
6911,text,525,1101,76,20,30_median.png,1024,1430,601,1121
6912,text,719,1101,62,18,30_median.png,1024,1430,781,1119
6913,text,529,1133,32,14,30_median.png,1024,1430,561,1147
6914,text,559,1129,36,20,30_median.png,1024,1430,595,1149
6915,text,719,1135,48,16,30_median.png,1024,1430,767,1151
6916,text,527,1159,86,20,30_median.png,1024,1430,613,1179
6917,text,721,1163,62,18,30_median.png,1024,1430,783,1181
6918,text,527,1189,181,20,30_median.png,1024,1430,708,1209
6919,text,717,1187,66,20,30_median.png,1024,1430,783,1207
6920,text,47,1209,146,18,30_median.png,1024,1430,193,1227
6921,text,197,1209,110,18,30_median.png,1024,1430,307,1227
6922,text,43,1227,274,21,30_median.png,1024,1430,317,1248
6923,text,42,1248,600,24,30_median.png,1024,1430,642,1272
6924,text,43,1271,468,20,30_median.png,1024,1430,511,1291
6925,text,761,1277,76,21,30_median.png,1024,1430,837,1298
6926,text,93,1331,98,16,30_median.png,1024,1430,191,1347
6927,text,195,1331,70,14,30_median.png,1024,1430,265,1345
6928,text,277,1329,80,16,30_median.png,1024,1430,357,1345
6929,text,533,1335,70,16,30_median.png,1024,1430,603,1351
6930,text,609,1333,82,16,30_median.png,1024,1430,691,1349
6931,text,705,1333,60,16,30_median.png,1024,1430,765,1349
6932,text,771,1327,198,20,30_median.png,1024,1430,969,1347
6933,text,63,1347,28,14,30_median.png,1024,1430,91,1361
6934,text,101,1345,118,16,30_median.png,1024,1430,219,1361
6935,text,229,1345,98,16,30_median.png,1024,1430,327,1361
6936,text,335,1345,30,14,30_median.png,1024,1430,365,1359
6937,text,373,1343,98,16,30_median.png,1024,1430,471,1359
6938,text,533,1353,100,16,30_median.png,1024,1430,633,1369
6939,text,645,1351,108,16,30_median.png,1024,1430,753,1367
6940,text,765,1351,48,14,30_median.png,1024,1430,813,1365
6941,text,823,1349,148,16,30_median.png,1024,1430,971,1365
6942,text,63,1363,32,14,30_median.png,1024,1430,95,1377
6943,text,105,1361,102,14,30_median.png,1024,1430,207,1375
6944,text,221,1361,50,14,30_median.png,1024,1430,271,1375
6945,text,289,1359,44,16,30_median.png,1024,1430,333,1375
6946,text,341,1359,68,16,30_median.png,1024,1430,409,1375
6947,text,854,1365,117,19,30_median.png,1024,1430,971,1384
6948,text,63,1377,54,14,30_median.png,1024,1430,117,1391
6949,text,127,1375,98,16,30_median.png,1024,1430,225,1391
6950,text,235,1375,120,14,30_median.png,1024,1430,355,1389
6951,text,365,1373,44,16,30_median.png,1024,1430,409,1389
6952,text,419,1373,36,16,30_median.png,1024,1430,455,1389
6953,text,463,1373,32,14,30_median.png,1024,1430,495,1387
6954,text,533,1371,64,16,30_median.png,1024,1430,597,1387
6955,text,609,1371,116,14,30_median.png,1024,1430,725,1385
6956,text,749,1369,104,14,30_median.png,1024,1430,853,1383
6957,text,39,548,22,25,30_median.png,1024,1430,61,573
6958,text,34,595,16,23,30_median.png,1024,1430,50,618
6959,text,33,616,17,22,30_median.png,1024,1430,50,638
6960,text,30,655,19,23,30_median.png,1024,1430,49,678
6961,text,32,692,17,26,30_median.png,1024,1430,49,718
6962,text,41,1287,169,18,30_median.png,1024,1430,210,1305
6963,text,63,1329,17,16,30_median.png,1024,1430,80,1345
6964,text,147,93,212,40,31.png,1024,1448,359,133
6965,text,533,215,256,20,31.png,1024,1448,789,235
6966,text,533,239,158,18,31.png,1024,1448,691,257
6967,text,531,285,88,20,31.png,1024,1448,619,305
6968,text,100,352,102,24,31.png,1024,1448,202,376
6969,text,212,352,102,24,31.png,1024,1448,314,376
6970,text,100,376,66,24,31.png,1024,1448,166,400
6971,text,210,376,92,24,31.png,1024,1448,302,400
6972,text,101,403,84,20,31.png,1024,1448,185,423
6973,text,211,403,92,20,31.png,1024,1448,303,423
6974,text,347,407,112,18,31.png,1024,1448,459,425
6975,text,499,405,82,20,31.png,1024,1448,581,425
6976,text,635,407,130,21,31.png,1024,1448,765,428
6977,text,787,407,94,20,31.png,1024,1448,881,427
6978,text,98,478,55,18,31.png,1024,1448,153,496
6979,text,567,483,24,14,31.png,1024,1448,591,497
6980,text,643,483,30,14,31.png,1024,1448,673,497
6981,text,695,483,70,14,31.png,1024,1448,765,497
6982,text,797,483,78,16,31.png,1024,1448,875,499
6983,text,519,505,34,14,31.png,1024,1448,553,519
6984,text,693,507,34,14,31.png,1024,1448,727,521
6985,text,797,507,32,14,31.png,1024,1448,829,521
6986,text,99,529,44,14,31.png,1024,1448,143,543
6987,text,561,529,68,18,31.png,1024,1448,629,547
6988,text,641,527,44,18,31.png,1024,1448,685,545
6989,text,727,531,52,16,31.png,1024,1448,779,547
6990,text,837,531,70,18,31.png,1024,1448,907,549
6991,text,99,553,76,14,31.png,1024,1448,175,567
6992,text,205,551,52,16,31.png,1024,1448,257,567
6993,text,585,553,44,16,31.png,1024,1448,629,569
6994,text,863,555,44,16,31.png,1024,1448,907,571
6995,text,457,577,44,16,31.png,1024,1448,501,593
6996,text,559,577,70,16,31.png,1024,1448,629,593
6997,text,837,579,70,16,31.png,1024,1448,907,595
6998,text,527,649,30,14,31.png,1024,1448,557,663
6999,text,599,651,72,14,31.png,1024,1448,671,665
7000,text,711,651,74,14,31.png,1024,1448,785,665
7001,text,815,651,76,16,31.png,1024,1448,891,667
7002,text,615,675,60,14,31.png,1024,1448,675,689
7003,text,731,675,45,14,31.png,1024,1448,776,689
7004,text,830,677,61,14,31.png,1024,1448,891,691
7005,text,523,699,34,12,31.png,1024,1448,557,711
7006,text,635,699,40,14,31.png,1024,1448,675,713
7007,text,851,701,40,14,31.png,1024,1448,891,715
7008,text,481,1127,44,16,31.png,1024,1448,525,1143
7009,text,685,1129,68,16,31.png,1024,1448,753,1145
7010,text,479,1151,58,16,31.png,1024,1448,537,1167
7011,text,683,1153,74,16,31.png,1024,1448,757,1169
7012,text,479,1175,86,16,31.png,1024,1448,565,1191
7013,text,683,1177,86,16,31.png,1024,1448,769,1193
7014,text,518,1201,68,14,31.png,1024,1448,586,1215
7015,text,591,1203,30,12,31.png,1024,1448,621,1215
7016,text,741,1201,52,16,31.png,1024,1448,793,1217
7017,text,797,1203,30,14,31.png,1024,1448,827,1217
7018,text,13,1378,184,18,31.png,1024,1448,197,1396
7019,text,197,1379,36,16,31.png,1024,1448,233,1395
7020,text,239,1381,328,16,31.png,1024,1448,567,1397
7021,text,573,1383,106,16,31.png,1024,1448,679,1399
7022,text,685,1383,38,16,31.png,1024,1448,723,1399
7023,text,729,1381,152,20,31.png,1024,1448,881,1401
7024,text,887,1385,96,16,31.png,1024,1448,983,1401
7025,text,351,1403,94,12,31.png,1024,1448,445,1415
7026,text,449,1403,52,14,31.png,1024,1448,501,1417
7027,text,507,1403,28,14,31.png,1024,1448,535,1417
7028,text,539,1403,61,14,31.png,1024,1448,600,1417
7029,text,789,1403,74,18,31.png,1024,1448,863,1421
7030,text,519,484,49,15,31.png,1024,1448,568,499
7031,text,179,552,19,16,31.png,1024,1448,198,568
7032,text,649,553,35,15,31.png,1024,1448,684,568
7033,text,741,555,37,13,31.png,1024,1448,778,568
7034,text,730,579,53,14,31.png,1024,1448,783,593
7035,text,740,699,38,15,31.png,1024,1448,778,714
7036,text,517,673,42,15,31.png,1024,1448,559,688
7037,text,687,1403,97,15,31.png,1024,1448,784,1418
7038,text,606,1400,74,17,31.png,1024,1448,680,1417
7039,text,147,93,212,40,31_contrasted.png,1024,1448,359,133
7040,text,533,215,256,20,31_contrasted.png,1024,1448,789,235
7041,text,533,239,158,18,31_contrasted.png,1024,1448,691,257
7042,text,531,285,88,20,31_contrasted.png,1024,1448,619,305
7043,text,100,352,102,24,31_contrasted.png,1024,1448,202,376
7044,text,212,352,102,24,31_contrasted.png,1024,1448,314,376
7045,text,100,376,66,24,31_contrasted.png,1024,1448,166,400
7046,text,210,376,92,24,31_contrasted.png,1024,1448,302,400
7047,text,101,403,84,20,31_contrasted.png,1024,1448,185,423
7048,text,211,403,92,20,31_contrasted.png,1024,1448,303,423
7049,text,347,407,112,18,31_contrasted.png,1024,1448,459,425
7050,text,499,405,82,20,31_contrasted.png,1024,1448,581,425
7051,text,635,407,130,21,31_contrasted.png,1024,1448,765,428
7052,text,787,407,94,20,31_contrasted.png,1024,1448,881,427
7053,text,98,478,55,18,31_contrasted.png,1024,1448,153,496
7054,text,567,483,24,14,31_contrasted.png,1024,1448,591,497
7055,text,643,483,30,14,31_contrasted.png,1024,1448,673,497
7056,text,695,483,70,14,31_contrasted.png,1024,1448,765,497
7057,text,797,483,78,16,31_contrasted.png,1024,1448,875,499
7058,text,519,505,34,14,31_contrasted.png,1024,1448,553,519
7059,text,693,507,34,14,31_contrasted.png,1024,1448,727,521
7060,text,797,507,32,14,31_contrasted.png,1024,1448,829,521
7061,text,99,529,44,14,31_contrasted.png,1024,1448,143,543
7062,text,561,529,68,18,31_contrasted.png,1024,1448,629,547
7063,text,641,527,44,18,31_contrasted.png,1024,1448,685,545
7064,text,727,531,52,16,31_contrasted.png,1024,1448,779,547
7065,text,837,531,70,18,31_contrasted.png,1024,1448,907,549
7066,text,99,553,76,14,31_contrasted.png,1024,1448,175,567
7067,text,205,551,52,16,31_contrasted.png,1024,1448,257,567
7068,text,585,553,44,16,31_contrasted.png,1024,1448,629,569
7069,text,863,555,44,16,31_contrasted.png,1024,1448,907,571
7070,text,457,577,44,16,31_contrasted.png,1024,1448,501,593
7071,text,559,577,70,16,31_contrasted.png,1024,1448,629,593
7072,text,837,579,70,16,31_contrasted.png,1024,1448,907,595
7073,text,527,649,30,14,31_contrasted.png,1024,1448,557,663
7074,text,599,651,72,14,31_contrasted.png,1024,1448,671,665
7075,text,711,651,74,14,31_contrasted.png,1024,1448,785,665
7076,text,815,651,76,16,31_contrasted.png,1024,1448,891,667
7077,text,615,675,60,14,31_contrasted.png,1024,1448,675,689
7078,text,731,675,45,14,31_contrasted.png,1024,1448,776,689
7079,text,830,677,61,14,31_contrasted.png,1024,1448,891,691
7080,text,523,699,34,12,31_contrasted.png,1024,1448,557,711
7081,text,635,699,40,14,31_contrasted.png,1024,1448,675,713
7082,text,851,701,40,14,31_contrasted.png,1024,1448,891,715
7083,text,481,1127,44,16,31_contrasted.png,1024,1448,525,1143
7084,text,685,1129,68,16,31_contrasted.png,1024,1448,753,1145
7085,text,479,1151,58,16,31_contrasted.png,1024,1448,537,1167
7086,text,683,1153,74,16,31_contrasted.png,1024,1448,757,1169
7087,text,479,1175,86,16,31_contrasted.png,1024,1448,565,1191
7088,text,683,1177,86,16,31_contrasted.png,1024,1448,769,1193
7089,text,518,1201,68,14,31_contrasted.png,1024,1448,586,1215
7090,text,591,1203,30,12,31_contrasted.png,1024,1448,621,1215
7091,text,741,1201,52,16,31_contrasted.png,1024,1448,793,1217
7092,text,797,1203,30,14,31_contrasted.png,1024,1448,827,1217
7093,text,13,1378,184,18,31_contrasted.png,1024,1448,197,1396
7094,text,197,1379,36,16,31_contrasted.png,1024,1448,233,1395
7095,text,239,1381,328,16,31_contrasted.png,1024,1448,567,1397
7096,text,573,1383,106,16,31_contrasted.png,1024,1448,679,1399
7097,text,685,1383,38,16,31_contrasted.png,1024,1448,723,1399
7098,text,729,1381,152,20,31_contrasted.png,1024,1448,881,1401
7099,text,887,1385,96,16,31_contrasted.png,1024,1448,983,1401
7100,text,351,1403,94,12,31_contrasted.png,1024,1448,445,1415
7101,text,449,1403,52,14,31_contrasted.png,1024,1448,501,1417
7102,text,507,1403,28,14,31_contrasted.png,1024,1448,535,1417
7103,text,539,1403,61,14,31_contrasted.png,1024,1448,600,1417
7104,text,789,1403,74,18,31_contrasted.png,1024,1448,863,1421
7105,text,519,484,49,15,31_contrasted.png,1024,1448,568,499
7106,text,179,552,19,16,31_contrasted.png,1024,1448,198,568
7107,text,649,553,35,15,31_contrasted.png,1024,1448,684,568
7108,text,741,555,37,13,31_contrasted.png,1024,1448,778,568
7109,text,730,579,53,14,31_contrasted.png,1024,1448,783,593
7110,text,740,699,38,15,31_contrasted.png,1024,1448,778,714
7111,text,517,673,42,15,31_contrasted.png,1024,1448,559,688
7112,text,687,1403,97,15,31_contrasted.png,1024,1448,784,1418
7113,text,606,1400,74,17,31_contrasted.png,1024,1448,680,1417
7114,text,147,93,212,40,31_denoise.png,1024,1448,359,133
7115,text,533,215,256,20,31_denoise.png,1024,1448,789,235
7116,text,533,239,158,18,31_denoise.png,1024,1448,691,257
7117,text,531,285,88,20,31_denoise.png,1024,1448,619,305
7118,text,100,352,102,24,31_denoise.png,1024,1448,202,376
7119,text,212,352,102,24,31_denoise.png,1024,1448,314,376
7120,text,100,376,66,24,31_denoise.png,1024,1448,166,400
7121,text,210,376,92,24,31_denoise.png,1024,1448,302,400
7122,text,101,403,84,20,31_denoise.png,1024,1448,185,423
7123,text,211,403,92,20,31_denoise.png,1024,1448,303,423
7124,text,347,407,112,18,31_denoise.png,1024,1448,459,425
7125,text,499,405,82,20,31_denoise.png,1024,1448,581,425
7126,text,635,407,130,21,31_denoise.png,1024,1448,765,428
7127,text,787,407,94,20,31_denoise.png,1024,1448,881,427
7128,text,98,478,55,18,31_denoise.png,1024,1448,153,496
7129,text,567,483,24,14,31_denoise.png,1024,1448,591,497
7130,text,643,483,30,14,31_denoise.png,1024,1448,673,497
7131,text,695,483,70,14,31_denoise.png,1024,1448,765,497
7132,text,797,483,78,16,31_denoise.png,1024,1448,875,499
7133,text,519,505,34,14,31_denoise.png,1024,1448,553,519
7134,text,693,507,34,14,31_denoise.png,1024,1448,727,521
7135,text,797,507,32,14,31_denoise.png,1024,1448,829,521
7136,text,99,529,44,14,31_denoise.png,1024,1448,143,543
7137,text,561,529,68,18,31_denoise.png,1024,1448,629,547
7138,text,641,527,44,18,31_denoise.png,1024,1448,685,545
7139,text,727,531,52,16,31_denoise.png,1024,1448,779,547
7140,text,837,531,70,18,31_denoise.png,1024,1448,907,549
7141,text,99,553,76,14,31_denoise.png,1024,1448,175,567
7142,text,205,551,52,16,31_denoise.png,1024,1448,257,567
7143,text,585,553,44,16,31_denoise.png,1024,1448,629,569
7144,text,863,555,44,16,31_denoise.png,1024,1448,907,571
7145,text,457,577,44,16,31_denoise.png,1024,1448,501,593
7146,text,559,577,70,16,31_denoise.png,1024,1448,629,593
7147,text,837,579,70,16,31_denoise.png,1024,1448,907,595
7148,text,527,649,30,14,31_denoise.png,1024,1448,557,663
7149,text,599,651,72,14,31_denoise.png,1024,1448,671,665
7150,text,711,651,74,14,31_denoise.png,1024,1448,785,665
7151,text,815,651,76,16,31_denoise.png,1024,1448,891,667
7152,text,615,675,60,14,31_denoise.png,1024,1448,675,689
7153,text,731,675,45,14,31_denoise.png,1024,1448,776,689
7154,text,830,677,61,14,31_denoise.png,1024,1448,891,691
7155,text,523,699,34,12,31_denoise.png,1024,1448,557,711
7156,text,635,699,40,14,31_denoise.png,1024,1448,675,713
7157,text,851,701,40,14,31_denoise.png,1024,1448,891,715
7158,text,481,1127,44,16,31_denoise.png,1024,1448,525,1143
7159,text,685,1129,68,16,31_denoise.png,1024,1448,753,1145
7160,text,479,1151,58,16,31_denoise.png,1024,1448,537,1167
7161,text,683,1153,74,16,31_denoise.png,1024,1448,757,1169
7162,text,479,1175,86,16,31_denoise.png,1024,1448,565,1191
7163,text,683,1177,86,16,31_denoise.png,1024,1448,769,1193
7164,text,518,1201,68,14,31_denoise.png,1024,1448,586,1215
7165,text,591,1203,30,12,31_denoise.png,1024,1448,621,1215
7166,text,741,1201,52,16,31_denoise.png,1024,1448,793,1217
7167,text,797,1203,30,14,31_denoise.png,1024,1448,827,1217
7168,text,13,1378,184,18,31_denoise.png,1024,1448,197,1396
7169,text,197,1379,36,16,31_denoise.png,1024,1448,233,1395
7170,text,239,1381,328,16,31_denoise.png,1024,1448,567,1397
7171,text,573,1383,106,16,31_denoise.png,1024,1448,679,1399
7172,text,685,1383,38,16,31_denoise.png,1024,1448,723,1399
7173,text,729,1381,152,20,31_denoise.png,1024,1448,881,1401
7174,text,887,1385,96,16,31_denoise.png,1024,1448,983,1401
7175,text,351,1403,94,12,31_denoise.png,1024,1448,445,1415
7176,text,449,1403,52,14,31_denoise.png,1024,1448,501,1417
7177,text,507,1403,28,14,31_denoise.png,1024,1448,535,1417
7178,text,539,1403,61,14,31_denoise.png,1024,1448,600,1417
7179,text,789,1403,74,18,31_denoise.png,1024,1448,863,1421
7180,text,519,484,49,15,31_denoise.png,1024,1448,568,499
7181,text,179,552,19,16,31_denoise.png,1024,1448,198,568
7182,text,649,553,35,15,31_denoise.png,1024,1448,684,568
7183,text,741,555,37,13,31_denoise.png,1024,1448,778,568
7184,text,730,579,53,14,31_denoise.png,1024,1448,783,593
7185,text,740,699,38,15,31_denoise.png,1024,1448,778,714
7186,text,517,673,42,15,31_denoise.png,1024,1448,559,688
7187,text,687,1403,97,15,31_denoise.png,1024,1448,784,1418
7188,text,606,1400,74,17,31_denoise.png,1024,1448,680,1417
7189,text,147,93,212,40,31_median.png,1024,1448,359,133
7190,text,533,215,256,20,31_median.png,1024,1448,789,235
7191,text,533,239,158,18,31_median.png,1024,1448,691,257
7192,text,531,285,88,20,31_median.png,1024,1448,619,305
7193,text,100,352,102,24,31_median.png,1024,1448,202,376
7194,text,212,352,102,24,31_median.png,1024,1448,314,376
7195,text,100,376,66,24,31_median.png,1024,1448,166,400
7196,text,210,376,92,24,31_median.png,1024,1448,302,400
7197,text,101,403,84,20,31_median.png,1024,1448,185,423
7198,text,211,403,92,20,31_median.png,1024,1448,303,423
7199,text,347,407,112,18,31_median.png,1024,1448,459,425
7200,text,499,405,82,20,31_median.png,1024,1448,581,425
7201,text,635,407,130,21,31_median.png,1024,1448,765,428
7202,text,787,407,94,20,31_median.png,1024,1448,881,427
7203,text,98,478,55,18,31_median.png,1024,1448,153,496
7204,text,567,483,24,14,31_median.png,1024,1448,591,497
7205,text,643,483,30,14,31_median.png,1024,1448,673,497
7206,text,695,483,70,14,31_median.png,1024,1448,765,497
7207,text,797,483,78,16,31_median.png,1024,1448,875,499
7208,text,519,505,34,14,31_median.png,1024,1448,553,519
7209,text,693,507,34,14,31_median.png,1024,1448,727,521
7210,text,797,507,32,14,31_median.png,1024,1448,829,521
7211,text,99,529,44,14,31_median.png,1024,1448,143,543
7212,text,561,529,68,18,31_median.png,1024,1448,629,547
7213,text,641,527,44,18,31_median.png,1024,1448,685,545
7214,text,727,531,52,16,31_median.png,1024,1448,779,547
7215,text,837,531,70,18,31_median.png,1024,1448,907,549
7216,text,99,553,76,14,31_median.png,1024,1448,175,567
7217,text,205,551,52,16,31_median.png,1024,1448,257,567
7218,text,585,553,44,16,31_median.png,1024,1448,629,569
7219,text,863,555,44,16,31_median.png,1024,1448,907,571
7220,text,457,577,44,16,31_median.png,1024,1448,501,593
7221,text,559,577,70,16,31_median.png,1024,1448,629,593
7222,text,837,579,70,16,31_median.png,1024,1448,907,595
7223,text,527,649,30,14,31_median.png,1024,1448,557,663
7224,text,599,651,72,14,31_median.png,1024,1448,671,665
7225,text,711,651,74,14,31_median.png,1024,1448,785,665
7226,text,815,651,76,16,31_median.png,1024,1448,891,667
7227,text,615,675,60,14,31_median.png,1024,1448,675,689
7228,text,731,675,45,14,31_median.png,1024,1448,776,689
7229,text,830,677,61,14,31_median.png,1024,1448,891,691
7230,text,523,699,34,12,31_median.png,1024,1448,557,711
7231,text,635,699,40,14,31_median.png,1024,1448,675,713
7232,text,851,701,40,14,31_median.png,1024,1448,891,715
7233,text,481,1127,44,16,31_median.png,1024,1448,525,1143
7234,text,685,1129,68,16,31_median.png,1024,1448,753,1145
7235,text,479,1151,58,16,31_median.png,1024,1448,537,1167
7236,text,683,1153,74,16,31_median.png,1024,1448,757,1169
7237,text,479,1175,86,16,31_median.png,1024,1448,565,1191
7238,text,683,1177,86,16,31_median.png,1024,1448,769,1193
7239,text,518,1201,68,14,31_median.png,1024,1448,586,1215
7240,text,591,1203,30,12,31_median.png,1024,1448,621,1215
7241,text,741,1201,52,16,31_median.png,1024,1448,793,1217
7242,text,797,1203,30,14,31_median.png,1024,1448,827,1217
7243,text,13,1378,184,18,31_median.png,1024,1448,197,1396
7244,text,197,1379,36,16,31_median.png,1024,1448,233,1395
7245,text,239,1381,328,16,31_median.png,1024,1448,567,1397
7246,text,573,1383,106,16,31_median.png,1024,1448,679,1399
7247,text,685,1383,38,16,31_median.png,1024,1448,723,1399
7248,text,729,1381,152,20,31_median.png,1024,1448,881,1401
7249,text,887,1385,96,16,31_median.png,1024,1448,983,1401
7250,text,351,1403,94,12,31_median.png,1024,1448,445,1415
7251,text,449,1403,52,14,31_median.png,1024,1448,501,1417
7252,text,507,1403,28,14,31_median.png,1024,1448,535,1417
7253,text,539,1403,61,14,31_median.png,1024,1448,600,1417
7254,text,789,1403,74,18,31_median.png,1024,1448,863,1421
7255,text,519,484,49,15,31_median.png,1024,1448,568,499
7256,text,179,552,19,16,31_median.png,1024,1448,198,568
7257,text,649,553,35,15,31_median.png,1024,1448,684,568
7258,text,741,555,37,13,31_median.png,1024,1448,778,568
7259,text,730,579,53,14,31_median.png,1024,1448,783,593
7260,text,740,699,38,15,31_median.png,1024,1448,778,714
7261,text,517,673,42,15,31_median.png,1024,1448,559,688
7262,text,687,1403,97,15,31_median.png,1024,1448,784,1418
7263,text,606,1400,74,17,31_median.png,1024,1448,680,1417
7264,text,404,124,346,50,32.png,1024,1448,750,174
7265,text,396,139,421,146,32.png,1024,1448,817,285
7266,text,679,423,128,20,32.png,1024,1448,807,443
7267,text,816,420,102,24,32.png,1024,1448,918,444
7268,text,636,490,214,24,32.png,1024,1448,850,514
7269,text,712,514,62,24,32.png,1024,1448,774,538
7270,text,634,538,46,24,32.png,1024,1448,680,562
7271,text,688,538,162,24,32.png,1024,1448,850,562
7272,text,410,644,232,26,32.png,1024,1448,642,670
7273,text,137,720,93,28,32.png,1024,1448,230,748
7274,text,138,770,74,26,32.png,1024,1448,212,796
7275,text,218,769,186,27,32.png,1024,1448,404,796
7276,text,410,766,112,28,32.png,1024,1448,522,794
7277,text,531,771,36,20,32.png,1024,1448,567,791
7278,text,574,765,256,29,32.png,1024,1448,830,794
7279,text,836,766,80,24,32.png,1024,1448,916,790
7280,text,136,796,84,26,32.png,1024,1448,220,822
7281,text,138,822,66,24,32.png,1024,1448,204,846
7282,text,215,816,359,31,32.png,1024,1448,574,847
7283,text,438,864,434,30,32.png,1024,1448,872,894
7284,text,372,918,100,24,32.png,1024,1448,472,942
7285,text,560,916,112,26,32.png,1024,1448,672,942
7286,text,374,968,92,24,32.png,1024,1448,466,992
7287,text,560,966,114,26,32.png,1024,1448,674,992
7288,text,378,1018,122,26,32.png,1024,1448,500,1044
7289,text,555,1016,127,26,32.png,1024,1448,682,1042
7290,text,136,1091,364,31,32.png,1024,1448,500,1122
7291,text,426,1142,218,26,32.png,1024,1448,644,1168
7292,text,230,1344,158,24,32.png,1024,1448,388,1368
7293,text,400,1344,345,29,32.png,1024,1448,745,1373
7294,text,46,1369,450,28,32.png,1024,1448,496,1397
7295,text,506,1372,416,26,32.png,1024,1448,922,1398
7296,text,110,1396,101,24,32.png,1024,1448,211,1420
7297,text,347,1399,102,20,32.png,1024,1448,449,1419
7298,text,460,1398,146,24,32.png,1024,1448,606,1422
7299,text,618,1400,198,24,32.png,1024,1448,816,1424
7300,text,222,1397,115,20,32.png,1024,1448,337,1417
7301,text,404,124,346,50,32_contrasted.png,1024,1448,750,174
7302,text,396,139,421,146,32_contrasted.png,1024,1448,817,285
7303,text,679,423,128,20,32_contrasted.png,1024,1448,807,443
7304,text,816,420,102,24,32_contrasted.png,1024,1448,918,444
7305,text,636,490,214,24,32_contrasted.png,1024,1448,850,514
7306,text,712,514,62,24,32_contrasted.png,1024,1448,774,538
7307,text,634,538,46,24,32_contrasted.png,1024,1448,680,562
7308,text,688,538,162,24,32_contrasted.png,1024,1448,850,562
7309,text,410,644,232,26,32_contrasted.png,1024,1448,642,670
7310,text,137,720,93,28,32_contrasted.png,1024,1448,230,748
7311,text,138,770,74,26,32_contrasted.png,1024,1448,212,796
7312,text,218,769,186,27,32_contrasted.png,1024,1448,404,796
7313,text,410,766,112,28,32_contrasted.png,1024,1448,522,794
7314,text,531,771,36,20,32_contrasted.png,1024,1448,567,791
7315,text,574,765,256,29,32_contrasted.png,1024,1448,830,794
7316,text,836,766,80,24,32_contrasted.png,1024,1448,916,790
7317,text,136,796,84,26,32_contrasted.png,1024,1448,220,822
7318,text,138,822,66,24,32_contrasted.png,1024,1448,204,846
7319,text,215,816,359,31,32_contrasted.png,1024,1448,574,847
7320,text,438,864,434,30,32_contrasted.png,1024,1448,872,894
7321,text,372,918,100,24,32_contrasted.png,1024,1448,472,942
7322,text,560,916,112,26,32_contrasted.png,1024,1448,672,942
7323,text,374,968,92,24,32_contrasted.png,1024,1448,466,992
7324,text,560,966,114,26,32_contrasted.png,1024,1448,674,992
7325,text,378,1018,122,26,32_contrasted.png,1024,1448,500,1044
7326,text,555,1016,127,26,32_contrasted.png,1024,1448,682,1042
7327,text,136,1091,364,31,32_contrasted.png,1024,1448,500,1122
7328,text,426,1142,218,26,32_contrasted.png,1024,1448,644,1168
7329,text,230,1344,158,24,32_contrasted.png,1024,1448,388,1368
7330,text,400,1344,345,29,32_contrasted.png,1024,1448,745,1373
7331,text,46,1369,450,28,32_contrasted.png,1024,1448,496,1397
7332,text,506,1372,416,26,32_contrasted.png,1024,1448,922,1398
7333,text,110,1396,101,24,32_contrasted.png,1024,1448,211,1420
7334,text,347,1399,102,20,32_contrasted.png,1024,1448,449,1419
7335,text,460,1398,146,24,32_contrasted.png,1024,1448,606,1422
7336,text,618,1400,198,24,32_contrasted.png,1024,1448,816,1424
7337,text,222,1397,115,20,32_contrasted.png,1024,1448,337,1417
7338,text,404,124,346,50,32_denoise.png,1024,1448,750,174
7339,text,396,139,421,146,32_denoise.png,1024,1448,817,285
7340,text,679,423,128,20,32_denoise.png,1024,1448,807,443
7341,text,816,420,102,24,32_denoise.png,1024,1448,918,444
7342,text,636,490,214,24,32_denoise.png,1024,1448,850,514
7343,text,712,514,62,24,32_denoise.png,1024,1448,774,538
7344,text,634,538,46,24,32_denoise.png,1024,1448,680,562
7345,text,688,538,162,24,32_denoise.png,1024,1448,850,562
7346,text,410,644,232,26,32_denoise.png,1024,1448,642,670
7347,text,137,720,93,28,32_denoise.png,1024,1448,230,748
7348,text,138,770,74,26,32_denoise.png,1024,1448,212,796
7349,text,218,769,186,27,32_denoise.png,1024,1448,404,796
7350,text,410,766,112,28,32_denoise.png,1024,1448,522,794
7351,text,531,771,36,20,32_denoise.png,1024,1448,567,791
7352,text,574,765,256,29,32_denoise.png,1024,1448,830,794
7353,text,836,766,80,24,32_denoise.png,1024,1448,916,790
7354,text,136,796,84,26,32_denoise.png,1024,1448,220,822
7355,text,138,822,66,24,32_denoise.png,1024,1448,204,846
7356,text,215,816,359,31,32_denoise.png,1024,1448,574,847
7357,text,438,864,434,30,32_denoise.png,1024,1448,872,894
7358,text,372,918,100,24,32_denoise.png,1024,1448,472,942
7359,text,560,916,112,26,32_denoise.png,1024,1448,672,942
7360,text,374,968,92,24,32_denoise.png,1024,1448,466,992
7361,text,560,966,114,26,32_denoise.png,1024,1448,674,992
7362,text,378,1018,122,26,32_denoise.png,1024,1448,500,1044
7363,text,555,1016,127,26,32_denoise.png,1024,1448,682,1042
7364,text,136,1091,364,31,32_denoise.png,1024,1448,500,1122
7365,text,426,1142,218,26,32_denoise.png,1024,1448,644,1168
7366,text,230,1344,158,24,32_denoise.png,1024,1448,388,1368
7367,text,400,1344,345,29,32_denoise.png,1024,1448,745,1373
7368,text,46,1369,450,28,32_denoise.png,1024,1448,496,1397
7369,text,506,1372,416,26,32_denoise.png,1024,1448,922,1398
7370,text,110,1396,101,24,32_denoise.png,1024,1448,211,1420
7371,text,347,1399,102,20,32_denoise.png,1024,1448,449,1419
7372,text,460,1398,146,24,32_denoise.png,1024,1448,606,1422
7373,text,618,1400,198,24,32_denoise.png,1024,1448,816,1424
7374,text,222,1397,115,20,32_denoise.png,1024,1448,337,1417
7375,text,404,124,346,50,32_median.png,1024,1448,750,174
7376,text,396,139,421,146,32_median.png,1024,1448,817,285
7377,text,679,423,128,20,32_median.png,1024,1448,807,443
7378,text,816,420,102,24,32_median.png,1024,1448,918,444
7379,text,636,490,214,24,32_median.png,1024,1448,850,514
7380,text,712,514,62,24,32_median.png,1024,1448,774,538
7381,text,634,538,46,24,32_median.png,1024,1448,680,562
7382,text,688,538,162,24,32_median.png,1024,1448,850,562
7383,text,410,644,232,26,32_median.png,1024,1448,642,670
7384,text,137,720,93,28,32_median.png,1024,1448,230,748
7385,text,138,770,74,26,32_median.png,1024,1448,212,796
7386,text,218,769,186,27,32_median.png,1024,1448,404,796
7387,text,410,766,112,28,32_median.png,1024,1448,522,794
7388,text,531,771,36,20,32_median.png,1024,1448,567,791
7389,text,574,765,256,29,32_median.png,1024,1448,830,794
7390,text,836,766,80,24,32_median.png,1024,1448,916,790
7391,text,136,796,84,26,32_median.png,1024,1448,220,822
7392,text,138,822,66,24,32_median.png,1024,1448,204,846
7393,text,215,816,359,31,32_median.png,1024,1448,574,847
7394,text,438,864,434,30,32_median.png,1024,1448,872,894
7395,text,372,918,100,24,32_median.png,1024,1448,472,942
7396,text,560,916,112,26,32_median.png,1024,1448,672,942
7397,text,374,968,92,24,32_median.png,1024,1448,466,992
7398,text,560,966,114,26,32_median.png,1024,1448,674,992
7399,text,378,1018,122,26,32_median.png,1024,1448,500,1044
7400,text,555,1016,127,26,32_median.png,1024,1448,682,1042
7401,text,136,1091,364,31,32_median.png,1024,1448,500,1122
7402,text,426,1142,218,26,32_median.png,1024,1448,644,1168
7403,text,230,1344,158,24,32_median.png,1024,1448,388,1368
7404,text,400,1344,345,29,32_median.png,1024,1448,745,1373
7405,text,46,1369,450,28,32_median.png,1024,1448,496,1397
7406,text,506,1372,416,26,32_median.png,1024,1448,922,1398
7407,text,110,1396,101,24,32_median.png,1024,1448,211,1420
7408,text,347,1399,102,20,32_median.png,1024,1448,449,1419
7409,text,460,1398,146,24,32_median.png,1024,1448,606,1422
7410,text,618,1400,198,24,32_median.png,1024,1448,816,1424
7411,text,222,1397,115,20,32_median.png,1024,1448,337,1417
7412,text,440,164,544,28,33.png,1024,1430,984,192
7413,text,373,185,54,20,33.png,1024,1430,427,205
7414,text,115,269,54,14,33.png,1024,1430,169,283
7415,text,249,267,32,16,33.png,1024,1430,281,283
7416,text,587,267,92,18,33.png,1024,1430,679,285
7417,text,113,301,84,20,33.png,1024,1430,197,321
7418,text,247,303,62,16,33.png,1024,1430,309,319
7419,text,587,321,232,20,33.png,1024,1430,819,341
7420,text,103,347,138,16,33.png,1024,1430,241,363
7421,text,593,365,80,16,33.png,1024,1430,673,381
7422,text,107,399,146,16,33.png,1024,1430,253,415
7423,text,765,431,142,20,33.png,1024,1430,907,451
7424,text,55,439,146,42,33.png,1024,1430,201,481
7425,text,67,539,88,18,33.png,1024,1430,155,557
7426,text,315,539,96,16,33.png,1024,1430,411,555
7427,text,611,537,32,16,33.png,1024,1430,643,553
7428,text,687,537,26,16,33.png,1024,1430,713,553
7429,text,721,537,26,14,33.png,1024,1430,747,551
7430,text,845,535,92,16,33.png,1024,1430,937,551
7431,text,957,535,38,14,33.png,1024,1430,995,549
7432,text,67,571,72,18,33.png,1024,1430,139,589
7433,text,165,569,172,20,33.png,1024,1430,337,589
7434,text,621,569,36,18,33.png,1024,1430,657,587
7435,text,713,567,44,18,33.png,1024,1430,757,585
7436,text,899,567,42,18,33.png,1024,1430,941,585
7437,text,961,569,28,16,33.png,1024,1430,989,585
7438,text,65,591,74,18,33.png,1024,1430,139,609
7439,text,165,589,196,20,33.png,1024,1430,361,609
7440,text,623,589,34,18,33.png,1024,1430,657,607
7441,text,715,589,42,16,33.png,1024,1430,757,605
7442,text,891,587,50,18,33.png,1024,1430,941,605
7443,text,959,587,30,18,33.png,1024,1430,989,605
7444,text,67,611,72,18,33.png,1024,1430,139,629
7445,text,166,609,179,21,33.png,1024,1430,345,630
7446,text,613,607,44,20,33.png,1024,1430,657,627
7447,text,723,609,34,18,33.png,1024,1430,757,627
7448,text,889,605,52,20,33.png,1024,1430,941,625
7449,text,959,609,30,14,33.png,1024,1430,989,623
7450,text,65,629,74,20,33.png,1024,1430,139,649
7451,text,165,628,156,21,33.png,1024,1430,321,649
7452,text,607,629,50,16,33.png,1024,1430,657,645
7453,text,723,629,34,16,33.png,1024,1430,757,645
7454,text,891,625,50,20,33.png,1024,1430,941,645
7455,text,959,629,30,14,33.png,1024,1430,989,643
7456,text,71,1095,36,14,33.png,1024,1430,107,1109
7457,text,175,1093,36,16,33.png,1024,1430,211,1109
7458,text,245,1093,36,14,33.png,1024,1430,281,1107
7459,text,335,1093,34,14,33.png,1024,1430,369,1107
7460,text,425,1089,56,18,33.png,1024,1430,481,1107
7461,text,501,1091,66,16,33.png,1024,1430,567,1107
7462,text,637,1091,32,16,33.png,1024,1430,669,1107
7463,text,711,1091,64,16,33.png,1024,1430,775,1107
7464,text,792,1090,61,18,33.png,1024,1430,853,1108
7465,text,879,1085,106,18,33.png,1024,1430,985,1103
7466,text,71,1131,30,16,33.png,1024,1430,101,1147
7467,text,165,1127,48,20,33.png,1024,1430,213,1147
7468,text,227,1127,56,20,33.png,1024,1430,283,1147
7469,text,321,1127,50,18,33.png,1024,1430,371,1145
7470,text,431,1127,50,18,33.png,1024,1430,481,1145
7471,text,537,1129,32,16,33.png,1024,1430,569,1145
7472,text,727,1127,52,18,33.png,1024,1430,779,1145
7473,text,825,1129,34,16,33.png,1024,1430,859,1145
7474,text,937,1127,50,16,33.png,1024,1430,987,1143
7475,text,75,1209,38,16,33.png,1024,1430,113,1225
7476,text,161,1207,50,18,33.png,1024,1430,211,1225
7477,text,319,1207,52,18,33.png,1024,1430,371,1225
7478,text,68,1234,336,24,33.png,1024,1430,404,1258
7479,text,69,1257,178,18,33.png,1024,1430,247,1275
7480,text,253,1257,186,20,33.png,1024,1430,439,1277
7481,text,79,1385,44,16,33.png,1024,1430,123,1401
7482,text,133,1379,282,20,33.png,1024,1430,415,1399
7483,text,421,1377,66,20,33.png,1024,1430,487,1397
7484,text,791,1376,174,20,33.png,1024,1430,965,1396
7485,text,264,1398,73,20,33.png,1024,1430,337,1418
7486,text,495,1377,139,18,33.png,1024,1430,634,1395
7487,text,641,1375,142,19,33.png,1024,1430,783,1394
7488,text,345,1398,109,20,33.png,1024,1430,454,1418
7489,text,464,1399,71,18,33.png,1024,1430,535,1417
7490,text,541,1397,93,21,33.png,1024,1430,634,1418
7491,text,642,1396,136,21,33.png,1024,1430,778,1417
7492,text,440,164,544,28,33_contrasted.png,1024,1430,984,192
7493,text,373,185,54,20,33_contrasted.png,1024,1430,427,205
7494,text,115,269,54,14,33_contrasted.png,1024,1430,169,283
7495,text,249,267,32,16,33_contrasted.png,1024,1430,281,283
7496,text,587,267,92,18,33_contrasted.png,1024,1430,679,285
7497,text,113,301,84,20,33_contrasted.png,1024,1430,197,321
7498,text,247,303,62,16,33_contrasted.png,1024,1430,309,319
7499,text,587,321,232,20,33_contrasted.png,1024,1430,819,341
7500,text,103,347,138,16,33_contrasted.png,1024,1430,241,363
7501,text,593,365,80,16,33_contrasted.png,1024,1430,673,381
7502,text,107,399,146,16,33_contrasted.png,1024,1430,253,415
7503,text,765,431,142,20,33_contrasted.png,1024,1430,907,451
7504,text,55,439,146,42,33_contrasted.png,1024,1430,201,481
7505,text,67,539,88,18,33_contrasted.png,1024,1430,155,557
7506,text,315,539,96,16,33_contrasted.png,1024,1430,411,555
7507,text,611,537,32,16,33_contrasted.png,1024,1430,643,553
7508,text,687,537,26,16,33_contrasted.png,1024,1430,713,553
7509,text,721,537,26,14,33_contrasted.png,1024,1430,747,551
7510,text,845,535,92,16,33_contrasted.png,1024,1430,937,551
7511,text,957,535,38,14,33_contrasted.png,1024,1430,995,549
7512,text,67,571,72,18,33_contrasted.png,1024,1430,139,589
7513,text,165,569,172,20,33_contrasted.png,1024,1430,337,589
7514,text,621,569,36,18,33_contrasted.png,1024,1430,657,587
7515,text,713,567,44,18,33_contrasted.png,1024,1430,757,585
7516,text,899,567,42,18,33_contrasted.png,1024,1430,941,585
7517,text,961,569,28,16,33_contrasted.png,1024,1430,989,585
7518,text,65,591,74,18,33_contrasted.png,1024,1430,139,609
7519,text,165,589,196,20,33_contrasted.png,1024,1430,361,609
7520,text,623,589,34,18,33_contrasted.png,1024,1430,657,607
7521,text,715,589,42,16,33_contrasted.png,1024,1430,757,605
7522,text,891,587,50,18,33_contrasted.png,1024,1430,941,605
7523,text,959,587,30,18,33_contrasted.png,1024,1430,989,605
7524,text,67,611,72,18,33_contrasted.png,1024,1430,139,629
7525,text,166,609,179,21,33_contrasted.png,1024,1430,345,630
7526,text,613,607,44,20,33_contrasted.png,1024,1430,657,627
7527,text,723,609,34,18,33_contrasted.png,1024,1430,757,627
7528,text,889,605,52,20,33_contrasted.png,1024,1430,941,625
7529,text,959,609,30,14,33_contrasted.png,1024,1430,989,623
7530,text,65,629,74,20,33_contrasted.png,1024,1430,139,649
7531,text,165,628,156,21,33_contrasted.png,1024,1430,321,649
7532,text,607,629,50,16,33_contrasted.png,1024,1430,657,645
7533,text,723,629,34,16,33_contrasted.png,1024,1430,757,645
7534,text,891,625,50,20,33_contrasted.png,1024,1430,941,645
7535,text,959,629,30,14,33_contrasted.png,1024,1430,989,643
7536,text,71,1095,36,14,33_contrasted.png,1024,1430,107,1109
7537,text,175,1093,36,16,33_contrasted.png,1024,1430,211,1109
7538,text,245,1093,36,14,33_contrasted.png,1024,1430,281,1107
7539,text,335,1093,34,14,33_contrasted.png,1024,1430,369,1107
7540,text,425,1089,56,18,33_contrasted.png,1024,1430,481,1107
7541,text,501,1091,66,16,33_contrasted.png,1024,1430,567,1107
7542,text,637,1091,32,16,33_contrasted.png,1024,1430,669,1107
7543,text,711,1091,64,16,33_contrasted.png,1024,1430,775,1107
7544,text,792,1090,61,18,33_contrasted.png,1024,1430,853,1108
7545,text,879,1085,106,18,33_contrasted.png,1024,1430,985,1103
7546,text,71,1131,30,16,33_contrasted.png,1024,1430,101,1147
7547,text,165,1127,48,20,33_contrasted.png,1024,1430,213,1147
7548,text,227,1127,56,20,33_contrasted.png,1024,1430,283,1147
7549,text,321,1127,50,18,33_contrasted.png,1024,1430,371,1145
7550,text,431,1127,50,18,33_contrasted.png,1024,1430,481,1145
7551,text,537,1129,32,16,33_contrasted.png,1024,1430,569,1145
7552,text,727,1127,52,18,33_contrasted.png,1024,1430,779,1145
7553,text,825,1129,34,16,33_contrasted.png,1024,1430,859,1145
7554,text,937,1127,50,16,33_contrasted.png,1024,1430,987,1143
7555,text,75,1209,38,16,33_contrasted.png,1024,1430,113,1225
7556,text,161,1207,50,18,33_contrasted.png,1024,1430,211,1225
7557,text,319,1207,52,18,33_contrasted.png,1024,1430,371,1225
7558,text,68,1234,336,24,33_contrasted.png,1024,1430,404,1258
7559,text,69,1257,178,18,33_contrasted.png,1024,1430,247,1275
7560,text,253,1257,186,20,33_contrasted.png,1024,1430,439,1277
7561,text,79,1385,44,16,33_contrasted.png,1024,1430,123,1401
7562,text,133,1379,282,20,33_contrasted.png,1024,1430,415,1399
7563,text,421,1377,66,20,33_contrasted.png,1024,1430,487,1397
7564,text,791,1376,174,20,33_contrasted.png,1024,1430,965,1396
7565,text,264,1398,73,20,33_contrasted.png,1024,1430,337,1418
7566,text,495,1377,139,18,33_contrasted.png,1024,1430,634,1395
7567,text,641,1375,142,19,33_contrasted.png,1024,1430,783,1394
7568,text,345,1398,109,20,33_contrasted.png,1024,1430,454,1418
7569,text,464,1399,71,18,33_contrasted.png,1024,1430,535,1417
7570,text,541,1397,93,21,33_contrasted.png,1024,1430,634,1418
7571,text,642,1396,136,21,33_contrasted.png,1024,1430,778,1417
7572,text,440,164,544,28,33_denoise.png,1024,1430,984,192
7573,text,373,185,54,20,33_denoise.png,1024,1430,427,205
7574,text,115,269,54,14,33_denoise.png,1024,1430,169,283
7575,text,249,267,32,16,33_denoise.png,1024,1430,281,283
7576,text,587,267,92,18,33_denoise.png,1024,1430,679,285
7577,text,113,301,84,20,33_denoise.png,1024,1430,197,321
7578,text,247,303,62,16,33_denoise.png,1024,1430,309,319
7579,text,587,321,232,20,33_denoise.png,1024,1430,819,341
7580,text,103,347,138,16,33_denoise.png,1024,1430,241,363
7581,text,593,365,80,16,33_denoise.png,1024,1430,673,381
7582,text,107,399,146,16,33_denoise.png,1024,1430,253,415
7583,text,765,431,142,20,33_denoise.png,1024,1430,907,451
7584,text,55,439,146,42,33_denoise.png,1024,1430,201,481
7585,text,67,539,88,18,33_denoise.png,1024,1430,155,557
7586,text,315,539,96,16,33_denoise.png,1024,1430,411,555
7587,text,611,537,32,16,33_denoise.png,1024,1430,643,553
7588,text,687,537,26,16,33_denoise.png,1024,1430,713,553
7589,text,721,537,26,14,33_denoise.png,1024,1430,747,551
7590,text,845,535,92,16,33_denoise.png,1024,1430,937,551
7591,text,957,535,38,14,33_denoise.png,1024,1430,995,549
7592,text,67,571,72,18,33_denoise.png,1024,1430,139,589
7593,text,165,569,172,20,33_denoise.png,1024,1430,337,589
7594,text,621,569,36,18,33_denoise.png,1024,1430,657,587
7595,text,713,567,44,18,33_denoise.png,1024,1430,757,585
7596,text,899,567,42,18,33_denoise.png,1024,1430,941,585
7597,text,961,569,28,16,33_denoise.png,1024,1430,989,585
7598,text,65,591,74,18,33_denoise.png,1024,1430,139,609
7599,text,165,589,196,20,33_denoise.png,1024,1430,361,609
7600,text,623,589,34,18,33_denoise.png,1024,1430,657,607
7601,text,715,589,42,16,33_denoise.png,1024,1430,757,605
7602,text,891,587,50,18,33_denoise.png,1024,1430,941,605
7603,text,959,587,30,18,33_denoise.png,1024,1430,989,605
7604,text,67,611,72,18,33_denoise.png,1024,1430,139,629
7605,text,166,609,179,21,33_denoise.png,1024,1430,345,630
7606,text,613,607,44,20,33_denoise.png,1024,1430,657,627
7607,text,723,609,34,18,33_denoise.png,1024,1430,757,627
7608,text,889,605,52,20,33_denoise.png,1024,1430,941,625
7609,text,959,609,30,14,33_denoise.png,1024,1430,989,623
7610,text,65,629,74,20,33_denoise.png,1024,1430,139,649
7611,text,165,628,156,21,33_denoise.png,1024,1430,321,649
7612,text,607,629,50,16,33_denoise.png,1024,1430,657,645
7613,text,723,629,34,16,33_denoise.png,1024,1430,757,645
7614,text,891,625,50,20,33_denoise.png,1024,1430,941,645
7615,text,959,629,30,14,33_denoise.png,1024,1430,989,643
7616,text,71,1095,36,14,33_denoise.png,1024,1430,107,1109
7617,text,175,1093,36,16,33_denoise.png,1024,1430,211,1109
7618,text,245,1093,36,14,33_denoise.png,1024,1430,281,1107
7619,text,335,1093,34,14,33_denoise.png,1024,1430,369,1107
7620,text,425,1089,56,18,33_denoise.png,1024,1430,481,1107
7621,text,501,1091,66,16,33_denoise.png,1024,1430,567,1107
7622,text,637,1091,32,16,33_denoise.png,1024,1430,669,1107
7623,text,711,1091,64,16,33_denoise.png,1024,1430,775,1107
7624,text,792,1090,61,18,33_denoise.png,1024,1430,853,1108
7625,text,879,1085,106,18,33_denoise.png,1024,1430,985,1103
7626,text,71,1131,30,16,33_denoise.png,1024,1430,101,1147
7627,text,165,1127,48,20,33_denoise.png,1024,1430,213,1147
7628,text,227,1127,56,20,33_denoise.png,1024,1430,283,1147
7629,text,321,1127,50,18,33_denoise.png,1024,1430,371,1145
7630,text,431,1127,50,18,33_denoise.png,1024,1430,481,1145
7631,text,537,1129,32,16,33_denoise.png,1024,1430,569,1145
7632,text,727,1127,52,18,33_denoise.png,1024,1430,779,1145
7633,text,825,1129,34,16,33_denoise.png,1024,1430,859,1145
7634,text,937,1127,50,16,33_denoise.png,1024,1430,987,1143
7635,text,75,1209,38,16,33_denoise.png,1024,1430,113,1225
7636,text,161,1207,50,18,33_denoise.png,1024,1430,211,1225
7637,text,319,1207,52,18,33_denoise.png,1024,1430,371,1225
7638,text,68,1234,336,24,33_denoise.png,1024,1430,404,1258
7639,text,69,1257,178,18,33_denoise.png,1024,1430,247,1275
7640,text,253,1257,186,20,33_denoise.png,1024,1430,439,1277
7641,text,79,1385,44,16,33_denoise.png,1024,1430,123,1401
7642,text,133,1379,282,20,33_denoise.png,1024,1430,415,1399
7643,text,421,1377,66,20,33_denoise.png,1024,1430,487,1397
7644,text,791,1376,174,20,33_denoise.png,1024,1430,965,1396
7645,text,264,1398,73,20,33_denoise.png,1024,1430,337,1418
7646,text,495,1377,139,18,33_denoise.png,1024,1430,634,1395
7647,text,641,1375,142,19,33_denoise.png,1024,1430,783,1394
7648,text,345,1398,109,20,33_denoise.png,1024,1430,454,1418
7649,text,464,1399,71,18,33_denoise.png,1024,1430,535,1417
7650,text,541,1397,93,21,33_denoise.png,1024,1430,634,1418
7651,text,642,1396,136,21,33_denoise.png,1024,1430,778,1417
7652,text,440,164,544,28,33_median.png,1024,1430,984,192
7653,text,373,185,54,20,33_median.png,1024,1430,427,205
7654,text,115,269,54,14,33_median.png,1024,1430,169,283
7655,text,249,267,32,16,33_median.png,1024,1430,281,283
7656,text,587,267,92,18,33_median.png,1024,1430,679,285
7657,text,113,301,84,20,33_median.png,1024,1430,197,321
7658,text,247,303,62,16,33_median.png,1024,1430,309,319
7659,text,587,321,232,20,33_median.png,1024,1430,819,341
7660,text,103,347,138,16,33_median.png,1024,1430,241,363
7661,text,593,365,80,16,33_median.png,1024,1430,673,381
7662,text,107,399,146,16,33_median.png,1024,1430,253,415
7663,text,765,431,142,20,33_median.png,1024,1430,907,451
7664,text,55,439,146,42,33_median.png,1024,1430,201,481
7665,text,67,539,88,18,33_median.png,1024,1430,155,557
7666,text,315,539,96,16,33_median.png,1024,1430,411,555
7667,text,611,537,32,16,33_median.png,1024,1430,643,553
7668,text,687,537,26,16,33_median.png,1024,1430,713,553
7669,text,721,537,26,14,33_median.png,1024,1430,747,551
7670,text,845,535,92,16,33_median.png,1024,1430,937,551
7671,text,957,535,38,14,33_median.png,1024,1430,995,549
7672,text,67,571,72,18,33_median.png,1024,1430,139,589
7673,text,165,569,172,20,33_median.png,1024,1430,337,589
7674,text,621,569,36,18,33_median.png,1024,1430,657,587
7675,text,713,567,44,18,33_median.png,1024,1430,757,585
7676,text,899,567,42,18,33_median.png,1024,1430,941,585
7677,text,961,569,28,16,33_median.png,1024,1430,989,585
7678,text,65,591,74,18,33_median.png,1024,1430,139,609
7679,text,165,589,196,20,33_median.png,1024,1430,361,609
7680,text,623,589,34,18,33_median.png,1024,1430,657,607
7681,text,715,589,42,16,33_median.png,1024,1430,757,605
7682,text,891,587,50,18,33_median.png,1024,1430,941,605
7683,text,959,587,30,18,33_median.png,1024,1430,989,605
7684,text,67,611,72,18,33_median.png,1024,1430,139,629
7685,text,166,609,179,21,33_median.png,1024,1430,345,630
7686,text,613,607,44,20,33_median.png,1024,1430,657,627
7687,text,723,609,34,18,33_median.png,1024,1430,757,627
7688,text,889,605,52,20,33_median.png,1024,1430,941,625
7689,text,959,609,30,14,33_median.png,1024,1430,989,623
7690,text,65,629,74,20,33_median.png,1024,1430,139,649
7691,text,165,628,156,21,33_median.png,1024,1430,321,649
7692,text,607,629,50,16,33_median.png,1024,1430,657,645
7693,text,723,629,34,16,33_median.png,1024,1430,757,645
7694,text,891,625,50,20,33_median.png,1024,1430,941,645
7695,text,959,629,30,14,33_median.png,1024,1430,989,643
7696,text,71,1095,36,14,33_median.png,1024,1430,107,1109
7697,text,175,1093,36,16,33_median.png,1024,1430,211,1109
7698,text,245,1093,36,14,33_median.png,1024,1430,281,1107
7699,text,335,1093,34,14,33_median.png,1024,1430,369,1107
7700,text,425,1089,56,18,33_median.png,1024,1430,481,1107
7701,text,501,1091,66,16,33_median.png,1024,1430,567,1107
7702,text,637,1091,32,16,33_median.png,1024,1430,669,1107
7703,text,711,1091,64,16,33_median.png,1024,1430,775,1107
7704,text,792,1090,61,18,33_median.png,1024,1430,853,1108
7705,text,879,1085,106,18,33_median.png,1024,1430,985,1103
7706,text,71,1131,30,16,33_median.png,1024,1430,101,1147
7707,text,165,1127,48,20,33_median.png,1024,1430,213,1147
7708,text,227,1127,56,20,33_median.png,1024,1430,283,1147
7709,text,321,1127,50,18,33_median.png,1024,1430,371,1145
7710,text,431,1127,50,18,33_median.png,1024,1430,481,1145
7711,text,537,1129,32,16,33_median.png,1024,1430,569,1145
7712,text,727,1127,52,18,33_median.png,1024,1430,779,1145
7713,text,825,1129,34,16,33_median.png,1024,1430,859,1145
7714,text,937,1127,50,16,33_median.png,1024,1430,987,1143
7715,text,75,1209,38,16,33_median.png,1024,1430,113,1225
7716,text,161,1207,50,18,33_median.png,1024,1430,211,1225
7717,text,319,1207,52,18,33_median.png,1024,1430,371,1225
7718,text,68,1234,336,24,33_median.png,1024,1430,404,1258
7719,text,69,1257,178,18,33_median.png,1024,1430,247,1275
7720,text,253,1257,186,20,33_median.png,1024,1430,439,1277
7721,text,79,1385,44,16,33_median.png,1024,1430,123,1401
7722,text,133,1379,282,20,33_median.png,1024,1430,415,1399
7723,text,421,1377,66,20,33_median.png,1024,1430,487,1397
7724,text,791,1376,174,20,33_median.png,1024,1430,965,1396
7725,text,264,1398,73,20,33_median.png,1024,1430,337,1418
7726,text,495,1377,139,18,33_median.png,1024,1430,634,1395
7727,text,641,1375,142,19,33_median.png,1024,1430,783,1394
7728,text,345,1398,109,20,33_median.png,1024,1430,454,1418
7729,text,464,1399,71,18,33_median.png,1024,1430,535,1417
7730,text,541,1397,93,21,33_median.png,1024,1430,634,1418
7731,text,642,1396,136,21,33_median.png,1024,1430,778,1417
7732,text,63,37,72,16,34.png,1024,1448,135,53
7733,text,539,35,62,16,34.png,1024,1448,601,51
7734,text,84,208,212,24,34.png,1024,1448,296,232
7735,text,382,206,178,24,34.png,1024,1448,560,230
7736,text,721,207,204,20,34.png,1024,1448,925,227
7737,text,85,229,60,20,34.png,1024,1448,145,249
7738,text,379,229,184,20,34.png,1024,1448,563,249
7739,text,779,227,156,18,34.png,1024,1448,935,245
7740,text,138,286,746,26,34.png,1024,1448,884,312
7741,text,463,347,86,18,34.png,1024,1448,549,365
7742,text,379,385,154,20,34.png,1024,1448,533,405
7743,text,382,406,171,21,34.png,1024,1448,553,427
7744,text,378,421,262,26,34.png,1024,1448,640,447
7745,text,381,445,48,20,34.png,1024,1448,429,465
7746,text,379,465,96,20,34.png,1024,1448,475,485
7747,text,380,487,201,20,34.png,1024,1448,581,507
7748,text,81,595,128,20,34.png,1024,1448,209,615
7749,text,219,594,112,20,34.png,1024,1448,331,614
7750,text,404,590,182,24,34.png,1024,1448,586,614
7751,text,663,591,104,20,34.png,1024,1448,767,611
7752,text,777,590,85,21,34.png,1024,1448,862,611
7753,text,335,643,100,20,34.png,1024,1448,435,663
7754,text,705,641,66,20,34.png,1024,1448,771,661
7755,text,801,641,38,20,34.png,1024,1448,839,661
7756,text,865,639,72,20,34.png,1024,1448,937,659
7757,text,92,673,364,29,34.png,1024,1448,456,702
7758,text,525,675,108,20,34.png,1024,1448,633,695
7759,text,701,683,74,20,34.png,1024,1448,775,703
7760,text,863,683,76,20,34.png,1024,1448,939,703
7761,text,89,701,100,16,34.png,1024,1448,189,717
7762,text,527,699,70,16,34.png,1024,1448,597,715
7763,text,93,731,164,18,34.png,1024,1448,257,749
7764,text,709,727,68,20,34.png,1024,1448,777,747
7765,text,795,727,60,20,34.png,1024,1448,855,747
7766,text,871,725,68,20,34.png,1024,1448,939,745
7767,text,91,763,132,20,34.png,1024,1448,223,783
7768,text,709,761,68,20,34.png,1024,1448,777,781
7769,text,797,759,58,20,34.png,1024,1448,855,779
7770,text,871,759,68,20,34.png,1024,1448,939,779
7771,text,630,823,63,21,34.png,1024,1448,693,844
7772,text,700,820,78,24,34.png,1024,1448,778,844
7773,text,785,821,68,20,34.png,1024,1448,853,841
7774,text,863,821,76,20,34.png,1024,1448,939,841
7775,text,433,879,146,19,34.png,1024,1448,579,898
7776,text,64,905,151,16,34.png,1024,1448,215,921
7777,text,89,925,38,14,34.png,1024,1448,127,939
7778,text,155,925,44,14,34.png,1024,1448,199,939
7779,text,204,924,39,14,34.png,1024,1448,243,938
7780,text,251,925,48,12,34.png,1024,1448,299,937
7781,text,307,925,30,12,34.png,1024,1448,337,937
7782,text,341,925,44,12,34.png,1024,1448,385,937
7783,text,419,923,88,14,34.png,1024,1448,507,937
7784,text,59,993,200,16,34.png,1024,1448,259,1009
7785,text,51,1379,252,16,34.png,1024,1448,303,1395
7786,text,300,1375,405,21,34.png,1024,1448,705,1396
7787,text,709,1374,209,17,34.png,1024,1448,918,1391
7788,text,866,589,68,22,34.png,1024,1448,934,611
7789,text,783,683,71,20,34.png,1024,1448,854,703
7790,text,62,923,20,16,34.png,1024,1448,82,939
7791,text,134,923,12,18,34.png,1024,1448,146,941
7792,text,393,923,20,15,34.png,1024,1448,413,938
7793,text,932,1373,22,17,34.png,1024,1448,954,1390
7794,text,63,37,72,16,34_contrasted.png,1024,1448,135,53
7795,text,539,35,62,16,34_contrasted.png,1024,1448,601,51
7796,text,84,208,212,24,34_contrasted.png,1024,1448,296,232
7797,text,382,206,178,24,34_contrasted.png,1024,1448,560,230
7798,text,721,207,204,20,34_contrasted.png,1024,1448,925,227
7799,text,85,229,60,20,34_contrasted.png,1024,1448,145,249
7800,text,379,229,184,20,34_contrasted.png,1024,1448,563,249
7801,text,779,227,156,18,34_contrasted.png,1024,1448,935,245
7802,text,138,286,746,26,34_contrasted.png,1024,1448,884,312
7803,text,463,347,86,18,34_contrasted.png,1024,1448,549,365
7804,text,379,385,154,20,34_contrasted.png,1024,1448,533,405
7805,text,382,406,171,21,34_contrasted.png,1024,1448,553,427
7806,text,378,421,262,26,34_contrasted.png,1024,1448,640,447
7807,text,381,445,48,20,34_contrasted.png,1024,1448,429,465
7808,text,379,465,96,20,34_contrasted.png,1024,1448,475,485
7809,text,380,487,201,20,34_contrasted.png,1024,1448,581,507
7810,text,81,595,128,20,34_contrasted.png,1024,1448,209,615
7811,text,219,594,112,20,34_contrasted.png,1024,1448,331,614
7812,text,404,590,182,24,34_contrasted.png,1024,1448,586,614
7813,text,663,591,104,20,34_contrasted.png,1024,1448,767,611
7814,text,777,590,85,21,34_contrasted.png,1024,1448,862,611
7815,text,335,643,100,20,34_contrasted.png,1024,1448,435,663
7816,text,705,641,66,20,34_contrasted.png,1024,1448,771,661
7817,text,801,641,38,20,34_contrasted.png,1024,1448,839,661
7818,text,865,639,72,20,34_contrasted.png,1024,1448,937,659
7819,text,92,673,364,29,34_contrasted.png,1024,1448,456,702
7820,text,525,675,108,20,34_contrasted.png,1024,1448,633,695
7821,text,701,683,74,20,34_contrasted.png,1024,1448,775,703
7822,text,863,683,76,20,34_contrasted.png,1024,1448,939,703
7823,text,89,701,100,16,34_contrasted.png,1024,1448,189,717
7824,text,527,699,70,16,34_contrasted.png,1024,1448,597,715
7825,text,93,731,164,18,34_contrasted.png,1024,1448,257,749
7826,text,709,727,68,20,34_contrasted.png,1024,1448,777,747
7827,text,795,727,60,20,34_contrasted.png,1024,1448,855,747
7828,text,871,725,68,20,34_contrasted.png,1024,1448,939,745
7829,text,91,763,132,20,34_contrasted.png,1024,1448,223,783
7830,text,709,761,68,20,34_contrasted.png,1024,1448,777,781
7831,text,797,759,58,20,34_contrasted.png,1024,1448,855,779
7832,text,871,759,68,20,34_contrasted.png,1024,1448,939,779
7833,text,630,823,63,21,34_contrasted.png,1024,1448,693,844
7834,text,700,820,78,24,34_contrasted.png,1024,1448,778,844
7835,text,785,821,68,20,34_contrasted.png,1024,1448,853,841
7836,text,863,821,76,20,34_contrasted.png,1024,1448,939,841
7837,text,433,879,146,19,34_contrasted.png,1024,1448,579,898
7838,text,64,905,151,16,34_contrasted.png,1024,1448,215,921
7839,text,89,925,38,14,34_contrasted.png,1024,1448,127,939
7840,text,155,925,44,14,34_contrasted.png,1024,1448,199,939
7841,text,204,924,39,14,34_contrasted.png,1024,1448,243,938
7842,text,251,925,48,12,34_contrasted.png,1024,1448,299,937
7843,text,307,925,30,12,34_contrasted.png,1024,1448,337,937
7844,text,341,925,44,12,34_contrasted.png,1024,1448,385,937
7845,text,419,923,88,14,34_contrasted.png,1024,1448,507,937
7846,text,59,993,200,16,34_contrasted.png,1024,1448,259,1009
7847,text,51,1379,252,16,34_contrasted.png,1024,1448,303,1395
7848,text,300,1375,405,21,34_contrasted.png,1024,1448,705,1396
7849,text,709,1374,209,17,34_contrasted.png,1024,1448,918,1391
7850,text,866,589,68,22,34_contrasted.png,1024,1448,934,611
7851,text,783,683,71,20,34_contrasted.png,1024,1448,854,703
7852,text,62,923,20,16,34_contrasted.png,1024,1448,82,939
7853,text,134,923,12,18,34_contrasted.png,1024,1448,146,941
7854,text,393,923,20,15,34_contrasted.png,1024,1448,413,938
7855,text,932,1373,22,17,34_contrasted.png,1024,1448,954,1390
7856,text,63,37,72,16,34_denoise.png,1024,1448,135,53
7857,text,539,35,62,16,34_denoise.png,1024,1448,601,51
7858,text,84,208,212,24,34_denoise.png,1024,1448,296,232
7859,text,382,206,178,24,34_denoise.png,1024,1448,560,230
7860,text,721,207,204,20,34_denoise.png,1024,1448,925,227
7861,text,85,229,60,20,34_denoise.png,1024,1448,145,249
7862,text,379,229,184,20,34_denoise.png,1024,1448,563,249
7863,text,779,227,156,18,34_denoise.png,1024,1448,935,245
7864,text,138,286,746,26,34_denoise.png,1024,1448,884,312
7865,text,463,347,86,18,34_denoise.png,1024,1448,549,365
7866,text,379,385,154,20,34_denoise.png,1024,1448,533,405
7867,text,382,406,171,21,34_denoise.png,1024,1448,553,427
7868,text,378,421,262,26,34_denoise.png,1024,1448,640,447
7869,text,381,445,48,20,34_denoise.png,1024,1448,429,465
7870,text,379,465,96,20,34_denoise.png,1024,1448,475,485
7871,text,380,487,201,20,34_denoise.png,1024,1448,581,507
7872,text,81,595,128,20,34_denoise.png,1024,1448,209,615
7873,text,219,594,112,20,34_denoise.png,1024,1448,331,614
7874,text,404,590,182,24,34_denoise.png,1024,1448,586,614
7875,text,663,591,104,20,34_denoise.png,1024,1448,767,611
7876,text,777,590,85,21,34_denoise.png,1024,1448,862,611
7877,text,335,643,100,20,34_denoise.png,1024,1448,435,663
7878,text,705,641,66,20,34_denoise.png,1024,1448,771,661
7879,text,801,641,38,20,34_denoise.png,1024,1448,839,661
7880,text,865,639,72,20,34_denoise.png,1024,1448,937,659
7881,text,92,673,364,29,34_denoise.png,1024,1448,456,702
7882,text,525,675,108,20,34_denoise.png,1024,1448,633,695
7883,text,701,683,74,20,34_denoise.png,1024,1448,775,703
7884,text,863,683,76,20,34_denoise.png,1024,1448,939,703
7885,text,89,701,100,16,34_denoise.png,1024,1448,189,717
7886,text,527,699,70,16,34_denoise.png,1024,1448,597,715
7887,text,93,731,164,18,34_denoise.png,1024,1448,257,749
7888,text,709,727,68,20,34_denoise.png,1024,1448,777,747
7889,text,795,727,60,20,34_denoise.png,1024,1448,855,747
7890,text,871,725,68,20,34_denoise.png,1024,1448,939,745
7891,text,91,763,132,20,34_denoise.png,1024,1448,223,783
7892,text,709,761,68,20,34_denoise.png,1024,1448,777,781
7893,text,797,759,58,20,34_denoise.png,1024,1448,855,779
7894,text,871,759,68,20,34_denoise.png,1024,1448,939,779
7895,text,630,823,63,21,34_denoise.png,1024,1448,693,844
7896,text,700,820,78,24,34_denoise.png,1024,1448,778,844
7897,text,785,821,68,20,34_denoise.png,1024,1448,853,841
7898,text,863,821,76,20,34_denoise.png,1024,1448,939,841
7899,text,433,879,146,19,34_denoise.png,1024,1448,579,898
7900,text,64,905,151,16,34_denoise.png,1024,1448,215,921
7901,text,89,925,38,14,34_denoise.png,1024,1448,127,939
7902,text,155,925,44,14,34_denoise.png,1024,1448,199,939
7903,text,204,924,39,14,34_denoise.png,1024,1448,243,938
7904,text,251,925,48,12,34_denoise.png,1024,1448,299,937
7905,text,307,925,30,12,34_denoise.png,1024,1448,337,937
7906,text,341,925,44,12,34_denoise.png,1024,1448,385,937
7907,text,419,923,88,14,34_denoise.png,1024,1448,507,937
7908,text,59,993,200,16,34_denoise.png,1024,1448,259,1009
7909,text,51,1379,252,16,34_denoise.png,1024,1448,303,1395
7910,text,300,1375,405,21,34_denoise.png,1024,1448,705,1396
7911,text,709,1374,209,17,34_denoise.png,1024,1448,918,1391
7912,text,866,589,68,22,34_denoise.png,1024,1448,934,611
7913,text,783,683,71,20,34_denoise.png,1024,1448,854,703
7914,text,62,923,20,16,34_denoise.png,1024,1448,82,939
7915,text,134,923,12,18,34_denoise.png,1024,1448,146,941
7916,text,393,923,20,15,34_denoise.png,1024,1448,413,938
7917,text,932,1373,22,17,34_denoise.png,1024,1448,954,1390
7918,text,63,37,72,16,34_median.png,1024,1448,135,53
7919,text,539,35,62,16,34_median.png,1024,1448,601,51
7920,text,84,208,212,24,34_median.png,1024,1448,296,232
7921,text,382,206,178,24,34_median.png,1024,1448,560,230
7922,text,721,207,204,20,34_median.png,1024,1448,925,227
7923,text,85,229,60,20,34_median.png,1024,1448,145,249
7924,text,379,229,184,20,34_median.png,1024,1448,563,249
7925,text,779,227,156,18,34_median.png,1024,1448,935,245
7926,text,138,286,746,26,34_median.png,1024,1448,884,312
7927,text,463,347,86,18,34_median.png,1024,1448,549,365
7928,text,379,385,154,20,34_median.png,1024,1448,533,405
7929,text,382,406,171,21,34_median.png,1024,1448,553,427
7930,text,378,421,262,26,34_median.png,1024,1448,640,447
7931,text,381,445,48,20,34_median.png,1024,1448,429,465
7932,text,379,465,96,20,34_median.png,1024,1448,475,485
7933,text,380,487,201,20,34_median.png,1024,1448,581,507
7934,text,81,595,128,20,34_median.png,1024,1448,209,615
7935,text,219,594,112,20,34_median.png,1024,1448,331,614
7936,text,404,590,182,24,34_median.png,1024,1448,586,614
7937,text,663,591,104,20,34_median.png,1024,1448,767,611
7938,text,777,590,85,21,34_median.png,1024,1448,862,611
7939,text,335,643,100,20,34_median.png,1024,1448,435,663
7940,text,705,641,66,20,34_median.png,1024,1448,771,661
7941,text,801,641,38,20,34_median.png,1024,1448,839,661
7942,text,865,639,72,20,34_median.png,1024,1448,937,659
7943,text,92,673,364,29,34_median.png,1024,1448,456,702
7944,text,525,675,108,20,34_median.png,1024,1448,633,695
7945,text,701,683,74,20,34_median.png,1024,1448,775,703
7946,text,863,683,76,20,34_median.png,1024,1448,939,703
7947,text,89,701,100,16,34_median.png,1024,1448,189,717
7948,text,527,699,70,16,34_median.png,1024,1448,597,715
7949,text,93,731,164,18,34_median.png,1024,1448,257,749
7950,text,709,727,68,20,34_median.png,1024,1448,777,747
7951,text,795,727,60,20,34_median.png,1024,1448,855,747
7952,text,871,725,68,20,34_median.png,1024,1448,939,745
7953,text,91,763,132,20,34_median.png,1024,1448,223,783
7954,text,709,761,68,20,34_median.png,1024,1448,777,781
7955,text,797,759,58,20,34_median.png,1024,1448,855,779
7956,text,871,759,68,20,34_median.png,1024,1448,939,779
7957,text,630,823,63,21,34_median.png,1024,1448,693,844
7958,text,700,820,78,24,34_median.png,1024,1448,778,844
7959,text,785,821,68,20,34_median.png,1024,1448,853,841
7960,text,863,821,76,20,34_median.png,1024,1448,939,841
7961,text,433,879,146,19,34_median.png,1024,1448,579,898
7962,text,64,905,151,16,34_median.png,1024,1448,215,921
7963,text,89,925,38,14,34_median.png,1024,1448,127,939
7964,text,155,925,44,14,34_median.png,1024,1448,199,939
7965,text,204,924,39,14,34_median.png,1024,1448,243,938
7966,text,251,925,48,12,34_median.png,1024,1448,299,937
7967,text,307,925,30,12,34_median.png,1024,1448,337,937
7968,text,341,925,44,12,34_median.png,1024,1448,385,937
7969,text,419,923,88,14,34_median.png,1024,1448,507,937
7970,text,59,993,200,16,34_median.png,1024,1448,259,1009
7971,text,51,1379,252,16,34_median.png,1024,1448,303,1395
7972,text,300,1375,405,21,34_median.png,1024,1448,705,1396
7973,text,709,1374,209,17,34_median.png,1024,1448,918,1391
7974,text,866,589,68,22,34_median.png,1024,1448,934,611
7975,text,783,683,71,20,34_median.png,1024,1448,854,703
7976,text,62,923,20,16,34_median.png,1024,1448,82,939
7977,text,134,923,12,18,34_median.png,1024,1448,146,941
7978,text,393,923,20,15,34_median.png,1024,1448,413,938
7979,text,932,1373,22,17,34_median.png,1024,1448,954,1390
7980,text,129,117,278,68,35.png,1024,1448,407,185
7981,text,125,187,278,20,35.png,1024,1448,403,207
7982,text,642,246,268,28,35.png,1024,1448,910,274
7983,text,658,295,251,27,35.png,1024,1448,909,322
7984,text,433,328,481,31,35.png,1024,1448,914,359
7985,text,728,363,182,27,35.png,1024,1448,910,390
7986,text,686,398,223,26,35.png,1024,1448,909,424
7987,text,73,457,225,28,35.png,1024,1448,298,485
7988,text,168,492,142,26,35.png,1024,1448,310,518
7989,text,418,494,106,26,35.png,1024,1448,524,520
7990,text,606,494,122,26,35.png,1024,1448,728,520
7991,text,774,494,118,26,35.png,1024,1448,892,520
7992,text,648,524,38,24,35.png,1024,1448,686,548
7993,text,814,524,38,24,35.png,1024,1448,852,548
7994,text,106,582,264,26,35.png,1024,1448,370,608
7995,text,624,584,84,26,35.png,1024,1448,708,610
7996,text,790,584,84,26,35.png,1024,1448,874,610
7997,text,612,641,107,28,35.png,1024,1448,719,669
7998,text,790,644,84,26,35.png,1024,1448,874,670
7999,text,614,674,104,24,35.png,1024,1448,718,698
8000,text,798,674,72,26,35.png,1024,1448,870,700
8001,text,608,704,114,24,35.png,1024,1448,722,728
8002,text,790,704,86,24,35.png,1024,1448,876,728
8003,text,76,754,554,28,35.png,1024,1448,630,782
8004,text,70,786,60,26,35.png,1024,1448,130,812
8005,text,70,814,350,28,35.png,1024,1448,420,842
8006,text,70,844,342,26,35.png,1024,1448,412,870
8007,text,69,1233,358,20,35.png,1024,1448,427,1253
8008,text,69,1277,290,20,35.png,1024,1448,359,1297
8009,text,67,1301,82,16,35.png,1024,1448,149,1317
8010,text,157,1299,88,18,35.png,1024,1448,245,1317
8011,text,253,1299,96,18,35.png,1024,1448,349,1317
8012,text,67,1323,144,16,35.png,1024,1448,211,1339
8013,text,219,1323,90,18,35.png,1024,1448,309,1341
8014,text,67,1343,78,20,35.png,1024,1448,145,1363
8015,text,149,1341,198,20,35.png,1024,1448,347,1361
8016,text,485,580,23,30,35.png,1024,1448,508,610
8017,text,129,117,278,68,35_contrasted.png,1024,1448,407,185
8018,text,125,187,278,20,35_contrasted.png,1024,1448,403,207
8019,text,642,246,268,28,35_contrasted.png,1024,1448,910,274
8020,text,658,295,251,27,35_contrasted.png,1024,1448,909,322
8021,text,433,328,481,31,35_contrasted.png,1024,1448,914,359
8022,text,728,363,182,27,35_contrasted.png,1024,1448,910,390
8023,text,686,398,223,26,35_contrasted.png,1024,1448,909,424
8024,text,73,457,225,28,35_contrasted.png,1024,1448,298,485
8025,text,168,492,142,26,35_contrasted.png,1024,1448,310,518
8026,text,418,494,106,26,35_contrasted.png,1024,1448,524,520
8027,text,606,494,122,26,35_contrasted.png,1024,1448,728,520
8028,text,774,494,118,26,35_contrasted.png,1024,1448,892,520
8029,text,648,524,38,24,35_contrasted.png,1024,1448,686,548
8030,text,814,524,38,24,35_contrasted.png,1024,1448,852,548
8031,text,106,582,264,26,35_contrasted.png,1024,1448,370,608
8032,text,624,584,84,26,35_contrasted.png,1024,1448,708,610
8033,text,790,584,84,26,35_contrasted.png,1024,1448,874,610
8034,text,612,641,107,28,35_contrasted.png,1024,1448,719,669
8035,text,790,644,84,26,35_contrasted.png,1024,1448,874,670
8036,text,614,674,104,24,35_contrasted.png,1024,1448,718,698
8037,text,798,674,72,26,35_contrasted.png,1024,1448,870,700
8038,text,608,704,114,24,35_contrasted.png,1024,1448,722,728
8039,text,790,704,86,24,35_contrasted.png,1024,1448,876,728
8040,text,76,754,554,28,35_contrasted.png,1024,1448,630,782
8041,text,70,786,60,26,35_contrasted.png,1024,1448,130,812
8042,text,70,814,350,28,35_contrasted.png,1024,1448,420,842
8043,text,70,844,342,26,35_contrasted.png,1024,1448,412,870
8044,text,69,1233,358,20,35_contrasted.png,1024,1448,427,1253
8045,text,69,1277,290,20,35_contrasted.png,1024,1448,359,1297
8046,text,67,1301,82,16,35_contrasted.png,1024,1448,149,1317
8047,text,157,1299,88,18,35_contrasted.png,1024,1448,245,1317
8048,text,253,1299,96,18,35_contrasted.png,1024,1448,349,1317
8049,text,67,1323,144,16,35_contrasted.png,1024,1448,211,1339
8050,text,219,1323,90,18,35_contrasted.png,1024,1448,309,1341
8051,text,67,1343,78,20,35_contrasted.png,1024,1448,145,1363
8052,text,149,1341,198,20,35_contrasted.png,1024,1448,347,1361
8053,text,485,580,23,30,35_contrasted.png,1024,1448,508,610
8054,text,129,117,278,68,35_denoise.png,1024,1448,407,185
8055,text,125,187,278,20,35_denoise.png,1024,1448,403,207
8056,text,642,246,268,28,35_denoise.png,1024,1448,910,274
8057,text,658,295,251,27,35_denoise.png,1024,1448,909,322
8058,text,433,328,481,31,35_denoise.png,1024,1448,914,359
8059,text,728,363,182,27,35_denoise.png,1024,1448,910,390
8060,text,686,398,223,26,35_denoise.png,1024,1448,909,424
8061,text,73,457,225,28,35_denoise.png,1024,1448,298,485
8062,text,168,492,142,26,35_denoise.png,1024,1448,310,518
8063,text,418,494,106,26,35_denoise.png,1024,1448,524,520
8064,text,606,494,122,26,35_denoise.png,1024,1448,728,520
8065,text,774,494,118,26,35_denoise.png,1024,1448,892,520
8066,text,648,524,38,24,35_denoise.png,1024,1448,686,548
8067,text,814,524,38,24,35_denoise.png,1024,1448,852,548
8068,text,106,582,264,26,35_denoise.png,1024,1448,370,608
8069,text,624,584,84,26,35_denoise.png,1024,1448,708,610
8070,text,790,584,84,26,35_denoise.png,1024,1448,874,610
8071,text,612,641,107,28,35_denoise.png,1024,1448,719,669
8072,text,790,644,84,26,35_denoise.png,1024,1448,874,670
8073,text,614,674,104,24,35_denoise.png,1024,1448,718,698
8074,text,798,674,72,26,35_denoise.png,1024,1448,870,700
8075,text,608,704,114,24,35_denoise.png,1024,1448,722,728
8076,text,790,704,86,24,35_denoise.png,1024,1448,876,728
8077,text,76,754,554,28,35_denoise.png,1024,1448,630,782
8078,text,70,786,60,26,35_denoise.png,1024,1448,130,812
8079,text,70,814,350,28,35_denoise.png,1024,1448,420,842
8080,text,70,844,342,26,35_denoise.png,1024,1448,412,870
8081,text,69,1233,358,20,35_denoise.png,1024,1448,427,1253
8082,text,69,1277,290,20,35_denoise.png,1024,1448,359,1297
8083,text,67,1301,82,16,35_denoise.png,1024,1448,149,1317
8084,text,157,1299,88,18,35_denoise.png,1024,1448,245,1317
8085,text,253,1299,96,18,35_denoise.png,1024,1448,349,1317
8086,text,67,1323,144,16,35_denoise.png,1024,1448,211,1339
8087,text,219,1323,90,18,35_denoise.png,1024,1448,309,1341
8088,text,67,1343,78,20,35_denoise.png,1024,1448,145,1363
8089,text,149,1341,198,20,35_denoise.png,1024,1448,347,1361
8090,text,485,580,23,30,35_denoise.png,1024,1448,508,610
8091,text,129,117,278,68,35_median.png,1024,1448,407,185
8092,text,125,187,278,20,35_median.png,1024,1448,403,207
8093,text,642,246,268,28,35_median.png,1024,1448,910,274
8094,text,658,295,251,27,35_median.png,1024,1448,909,322
8095,text,433,328,481,31,35_median.png,1024,1448,914,359
8096,text,728,363,182,27,35_median.png,1024,1448,910,390
8097,text,686,398,223,26,35_median.png,1024,1448,909,424
8098,text,73,457,225,28,35_median.png,1024,1448,298,485
8099,text,168,492,142,26,35_median.png,1024,1448,310,518
8100,text,418,494,106,26,35_median.png,1024,1448,524,520
8101,text,606,494,122,26,35_median.png,1024,1448,728,520
8102,text,774,494,118,26,35_median.png,1024,1448,892,520
8103,text,648,524,38,24,35_median.png,1024,1448,686,548
8104,text,814,524,38,24,35_median.png,1024,1448,852,548
8105,text,106,582,264,26,35_median.png,1024,1448,370,608
8106,text,624,584,84,26,35_median.png,1024,1448,708,610
8107,text,790,584,84,26,35_median.png,1024,1448,874,610
8108,text,612,641,107,28,35_median.png,1024,1448,719,669
8109,text,790,644,84,26,35_median.png,1024,1448,874,670
8110,text,614,674,104,24,35_median.png,1024,1448,718,698
8111,text,798,674,72,26,35_median.png,1024,1448,870,700
8112,text,608,704,114,24,35_median.png,1024,1448,722,728
8113,text,790,704,86,24,35_median.png,1024,1448,876,728
8114,text,76,754,554,28,35_median.png,1024,1448,630,782
8115,text,70,786,60,26,35_median.png,1024,1448,130,812
8116,text,70,814,350,28,35_median.png,1024,1448,420,842
8117,text,70,844,342,26,35_median.png,1024,1448,412,870
8118,text,69,1233,358,20,35_median.png,1024,1448,427,1253
8119,text,69,1277,290,20,35_median.png,1024,1448,359,1297
8120,text,67,1301,82,16,35_median.png,1024,1448,149,1317
8121,text,157,1299,88,18,35_median.png,1024,1448,245,1317
8122,text,253,1299,96,18,35_median.png,1024,1448,349,1317
8123,text,67,1323,144,16,35_median.png,1024,1448,211,1339
8124,text,219,1323,90,18,35_median.png,1024,1448,309,1341
8125,text,67,1343,78,20,35_median.png,1024,1448,145,1363
8126,text,149,1341,198,20,35_median.png,1024,1448,347,1361
8127,text,485,580,23,30,35_median.png,1024,1448,508,610
8128,text,865,41,118,20,36.png,1024,1448,983,61
8129,text,899,63,82,16,36.png,1024,1448,981,79
8130,text,837,77,28,20,36.png,1024,1448,865,97
8131,text,877,77,104,20,36.png,1024,1448,981,97
8132,text,19,78,231,40,36.png,1024,1448,250,118
8133,text,877,95,104,20,36.png,1024,1448,981,115
8134,text,841,115,28,16,36.png,1024,1448,869,131
8135,text,875,113,106,18,36.png,1024,1448,981,131
8136,text,621,206,133,30,36.png,1024,1448,754,236
8137,text,86,256,160,28,36.png,1024,1448,246,284
8138,text,272,256,86,26,36.png,1024,1448,358,282
8139,text,797,255,78,16,36.png,1024,1448,875,271
8140,text,501,297,116,20,36.png,1024,1448,617,317
8141,text,498,322,204,24,36.png,1024,1448,702,346
8142,text,500,343,292,24,36.png,1024,1448,792,367
8143,text,499,367,120,20,36.png,1024,1448,619,387
8144,text,602,394,38,24,36.png,1024,1448,640,418
8145,text,646,394,152,24,36.png,1024,1448,798,418
8146,text,35,428,97,28,36.png,1024,1448,132,456
8147,text,271,431,113,31,36.png,1024,1448,384,462
8148,text,562,434,84,24,36.png,1024,1448,646,458
8149,text,696,432,116,26,36.png,1024,1448,812,458
8150,text,858,432,84,24,36.png,1024,1448,942,456
8151,text,39,497,64,20,36.png,1024,1448,103,517
8152,text,163,499,296,20,36.png,1024,1448,459,519
8153,text,633,497,40,20,36.png,1024,1448,673,517
8154,text,743,497,52,20,36.png,1024,1448,795,517
8155,text,899,497,60,20,36.png,1024,1448,959,517
8156,text,609,1287,98,20,36.png,1024,1448,707,1307
8157,text,825,1285,68,20,36.png,1024,1448,893,1305
8158,text,611,1313,52,20,36.png,1024,1448,663,1333
8159,text,670,1314,66,24,36.png,1024,1448,736,1338
8160,text,833,1313,60,20,36.png,1024,1448,893,1333
8161,text,607,1349,112,20,36.png,1024,1448,719,1369
8162,text,818,1344,76,24,36.png,1024,1448,894,1368
8163,text,44,1366,96,24,36.png,1024,1448,140,1390
8164,text,150,1365,370,25,36.png,1024,1448,520,1390
8165,text,47,1395,98,16,36.png,1024,1448,145,1411
8166,text,152,1390,152,24,36.png,1024,1448,304,1414
8167,text,325,1433,192,15,36.png,1024,1448,517,1448
8168,text,529,1435,140,13,36.png,1024,1448,669,1448
8169,text,680,1435,109,13,36.png,1024,1448,789,1448
8170,text,802,1433,165,15,36.png,1024,1448,967,1448
8171,text,21,1432,290,16,36.png,1024,1448,311,1448
8172,text,865,41,118,20,36_contrasted.png,1024,1448,983,61
8173,text,899,63,82,16,36_contrasted.png,1024,1448,981,79
8174,text,837,77,28,20,36_contrasted.png,1024,1448,865,97
8175,text,877,77,104,20,36_contrasted.png,1024,1448,981,97
8176,text,19,78,231,40,36_contrasted.png,1024,1448,250,118
8177,text,877,95,104,20,36_contrasted.png,1024,1448,981,115
8178,text,841,115,28,16,36_contrasted.png,1024,1448,869,131
8179,text,875,113,106,18,36_contrasted.png,1024,1448,981,131
8180,text,621,206,133,30,36_contrasted.png,1024,1448,754,236
8181,text,86,256,160,28,36_contrasted.png,1024,1448,246,284
8182,text,272,256,86,26,36_contrasted.png,1024,1448,358,282
8183,text,797,255,78,16,36_contrasted.png,1024,1448,875,271
8184,text,501,297,116,20,36_contrasted.png,1024,1448,617,317
8185,text,498,322,204,24,36_contrasted.png,1024,1448,702,346
8186,text,500,343,292,24,36_contrasted.png,1024,1448,792,367
8187,text,499,367,120,20,36_contrasted.png,1024,1448,619,387
8188,text,602,394,38,24,36_contrasted.png,1024,1448,640,418
8189,text,646,394,152,24,36_contrasted.png,1024,1448,798,418
8190,text,35,428,97,28,36_contrasted.png,1024,1448,132,456
8191,text,271,431,113,31,36_contrasted.png,1024,1448,384,462
8192,text,562,434,84,24,36_contrasted.png,1024,1448,646,458
8193,text,696,432,116,26,36_contrasted.png,1024,1448,812,458
8194,text,858,432,84,24,36_contrasted.png,1024,1448,942,456
8195,text,39,497,64,20,36_contrasted.png,1024,1448,103,517
8196,text,163,499,296,20,36_contrasted.png,1024,1448,459,519
8197,text,633,497,40,20,36_contrasted.png,1024,1448,673,517
8198,text,743,497,52,20,36_contrasted.png,1024,1448,795,517
8199,text,899,497,60,20,36_contrasted.png,1024,1448,959,517
8200,text,609,1287,98,20,36_contrasted.png,1024,1448,707,1307
8201,text,825,1285,68,20,36_contrasted.png,1024,1448,893,1305
8202,text,611,1313,52,20,36_contrasted.png,1024,1448,663,1333
8203,text,670,1314,66,24,36_contrasted.png,1024,1448,736,1338
8204,text,833,1313,60,20,36_contrasted.png,1024,1448,893,1333
8205,text,607,1349,112,20,36_contrasted.png,1024,1448,719,1369
8206,text,818,1344,76,24,36_contrasted.png,1024,1448,894,1368
8207,text,44,1366,96,24,36_contrasted.png,1024,1448,140,1390
8208,text,150,1365,370,25,36_contrasted.png,1024,1448,520,1390
8209,text,47,1395,98,16,36_contrasted.png,1024,1448,145,1411
8210,text,152,1390,152,24,36_contrasted.png,1024,1448,304,1414
8211,text,325,1433,192,15,36_contrasted.png,1024,1448,517,1448
8212,text,529,1435,140,13,36_contrasted.png,1024,1448,669,1448
8213,text,680,1435,109,13,36_contrasted.png,1024,1448,789,1448
8214,text,802,1433,165,15,36_contrasted.png,1024,1448,967,1448
8215,text,21,1432,290,16,36_contrasted.png,1024,1448,311,1448
8216,text,865,41,118,20,36_denoise.png,1024,1448,983,61
8217,text,899,63,82,16,36_denoise.png,1024,1448,981,79
8218,text,837,77,28,20,36_denoise.png,1024,1448,865,97
8219,text,877,77,104,20,36_denoise.png,1024,1448,981,97
8220,text,19,78,231,40,36_denoise.png,1024,1448,250,118
8221,text,877,95,104,20,36_denoise.png,1024,1448,981,115
8222,text,841,115,28,16,36_denoise.png,1024,1448,869,131
8223,text,875,113,106,18,36_denoise.png,1024,1448,981,131
8224,text,621,206,133,30,36_denoise.png,1024,1448,754,236
8225,text,86,256,160,28,36_denoise.png,1024,1448,246,284
8226,text,272,256,86,26,36_denoise.png,1024,1448,358,282
8227,text,797,255,78,16,36_denoise.png,1024,1448,875,271
8228,text,501,297,116,20,36_denoise.png,1024,1448,617,317
8229,text,498,322,204,24,36_denoise.png,1024,1448,702,346
8230,text,500,343,292,24,36_denoise.png,1024,1448,792,367
8231,text,499,367,120,20,36_denoise.png,1024,1448,619,387
8232,text,602,394,38,24,36_denoise.png,1024,1448,640,418
8233,text,646,394,152,24,36_denoise.png,1024,1448,798,418
8234,text,35,428,97,28,36_denoise.png,1024,1448,132,456
8235,text,271,431,113,31,36_denoise.png,1024,1448,384,462
8236,text,562,434,84,24,36_denoise.png,1024,1448,646,458
8237,text,696,432,116,26,36_denoise.png,1024,1448,812,458
8238,text,858,432,84,24,36_denoise.png,1024,1448,942,456
8239,text,39,497,64,20,36_denoise.png,1024,1448,103,517
8240,text,163,499,296,20,36_denoise.png,1024,1448,459,519
8241,text,633,497,40,20,36_denoise.png,1024,1448,673,517
8242,text,743,497,52,20,36_denoise.png,1024,1448,795,517
8243,text,899,497,60,20,36_denoise.png,1024,1448,959,517
8244,text,609,1287,98,20,36_denoise.png,1024,1448,707,1307
8245,text,825,1285,68,20,36_denoise.png,1024,1448,893,1305
8246,text,611,1313,52,20,36_denoise.png,1024,1448,663,1333
8247,text,670,1314,66,24,36_denoise.png,1024,1448,736,1338
8248,text,833,1313,60,20,36_denoise.png,1024,1448,893,1333
8249,text,607,1349,112,20,36_denoise.png,1024,1448,719,1369
8250,text,818,1344,76,24,36_denoise.png,1024,1448,894,1368
8251,text,44,1366,96,24,36_denoise.png,1024,1448,140,1390
8252,text,150,1365,370,25,36_denoise.png,1024,1448,520,1390
8253,text,47,1395,98,16,36_denoise.png,1024,1448,145,1411
8254,text,152,1390,152,24,36_denoise.png,1024,1448,304,1414
8255,text,325,1433,192,15,36_denoise.png,1024,1448,517,1448
8256,text,529,1435,140,13,36_denoise.png,1024,1448,669,1448
8257,text,680,1435,109,13,36_denoise.png,1024,1448,789,1448
8258,text,802,1433,165,15,36_denoise.png,1024,1448,967,1448
8259,text,21,1432,290,16,36_denoise.png,1024,1448,311,1448
8260,text,865,41,118,20,36_median.png,1024,1448,983,61
8261,text,899,63,82,16,36_median.png,1024,1448,981,79
8262,text,837,77,28,20,36_median.png,1024,1448,865,97
8263,text,877,77,104,20,36_median.png,1024,1448,981,97
8264,text,19,78,231,40,36_median.png,1024,1448,250,118
8265,text,877,95,104,20,36_median.png,1024,1448,981,115
8266,text,841,115,28,16,36_median.png,1024,1448,869,131
8267,text,875,113,106,18,36_median.png,1024,1448,981,131
8268,text,621,206,133,30,36_median.png,1024,1448,754,236
8269,text,86,256,160,28,36_median.png,1024,1448,246,284
8270,text,272,256,86,26,36_median.png,1024,1448,358,282
8271,text,797,255,78,16,36_median.png,1024,1448,875,271
8272,text,501,297,116,20,36_median.png,1024,1448,617,317
8273,text,498,322,204,24,36_median.png,1024,1448,702,346
8274,text,500,343,292,24,36_median.png,1024,1448,792,367
8275,text,499,367,120,20,36_median.png,1024,1448,619,387
8276,text,602,394,38,24,36_median.png,1024,1448,640,418
8277,text,646,394,152,24,36_median.png,1024,1448,798,418
8278,text,35,428,97,28,36_median.png,1024,1448,132,456
8279,text,271,431,113,31,36_median.png,1024,1448,384,462
8280,text,562,434,84,24,36_median.png,1024,1448,646,458
8281,text,696,432,116,26,36_median.png,1024,1448,812,458
8282,text,858,432,84,24,36_median.png,1024,1448,942,456
8283,text,39,497,64,20,36_median.png,1024,1448,103,517
8284,text,163,499,296,20,36_median.png,1024,1448,459,519
8285,text,633,497,40,20,36_median.png,1024,1448,673,517
8286,text,743,497,52,20,36_median.png,1024,1448,795,517
8287,text,899,497,60,20,36_median.png,1024,1448,959,517
8288,text,609,1287,98,20,36_median.png,1024,1448,707,1307
8289,text,825,1285,68,20,36_median.png,1024,1448,893,1305
8290,text,611,1313,52,20,36_median.png,1024,1448,663,1333
8291,text,670,1314,66,24,36_median.png,1024,1448,736,1338
8292,text,833,1313,60,20,36_median.png,1024,1448,893,1333
8293,text,607,1349,112,20,36_median.png,1024,1448,719,1369
8294,text,818,1344,76,24,36_median.png,1024,1448,894,1368
8295,text,44,1366,96,24,36_median.png,1024,1448,140,1390
8296,text,150,1365,370,25,36_median.png,1024,1448,520,1390
8297,text,47,1395,98,16,36_median.png,1024,1448,145,1411
8298,text,152,1390,152,24,36_median.png,1024,1448,304,1414
8299,text,325,1433,192,15,36_median.png,1024,1448,517,1448
8300,text,529,1435,140,13,36_median.png,1024,1448,669,1448
8301,text,680,1435,109,13,36_median.png,1024,1448,789,1448
8302,text,802,1433,165,15,36_median.png,1024,1448,967,1448
8303,text,21,1432,290,16,36_median.png,1024,1448,311,1448
8304,text,132,96,86,24,37.png,1024,1430,218,120
8305,text,224,96,92,24,37.png,1024,1430,316,120
8306,text,322,96,34,24,37.png,1024,1430,356,120
8307,text,368,96,56,24,37.png,1024,1430,424,120
8308,text,604,83,354,33,37.png,1024,1430,958,116
8309,text,477,133,100,20,37.png,1024,1430,577,153
8310,text,40,178,178,25,37.png,1024,1430,218,203
8311,text,470,182,178,26,37.png,1024,1430,648,208
8312,text,654,184,76,24,37.png,1024,1430,730,208
8313,text,40,202,128,24,37.png,1024,1430,168,226
8314,text,41,227,126,20,37.png,1024,1430,167,247
8315,text,471,219,256,20,37.png,1024,1430,727,239
8316,text,472,240,248,24,37.png,1024,1430,720,264
8317,text,470,266,118,24,37.png,1024,1430,588,290
8318,text,469,291,44,20,37.png,1024,1430,513,311
8319,text,529,291,140,20,37.png,1024,1430,669,311
8320,text,57,361,50,20,37.png,1024,1430,107,381
8321,text,186,356,110,24,37.png,1024,1430,296,380
8322,text,333,361,118,20,37.png,1024,1430,451,381
8323,text,474,358,152,24,37.png,1024,1430,626,382
8324,text,659,359,54,20,37.png,1024,1430,713,379
8325,text,723,359,42,20,37.png,1024,1430,765,379
8326,text,821,359,54,20,37.png,1024,1430,875,379
8327,text,885,359,38,20,37.png,1024,1430,923,379
8328,text,42,389,90,20,37.png,1024,1430,132,409
8329,text,208,388,74,24,37.png,1024,1430,282,412
8330,text,368,388,62,24,37.png,1024,1430,430,412
8331,text,487,387,114,20,37.png,1024,1430,601,407
8332,text,647,387,134,20,37.png,1024,1430,781,407
8333,text,807,387,106,20,37.png,1024,1430,913,407
8334,text,37,433,102,20,37.png,1024,1430,139,453
8335,text,270,430,100,24,37.png,1024,1430,370,454
8336,text,489,431,36,20,37.png,1024,1430,525,451
8337,text,549,431,48,20,37.png,1024,1430,597,451
8338,text,631,431,38,18,37.png,1024,1430,669,449
8339,text,685,429,100,20,37.png,1024,1430,785,449
8340,text,815,429,92,20,37.png,1024,1430,907,449
8341,text,139,467,58,20,37.png,1024,1430,197,487
8342,text,33,491,92,20,37.png,1024,1430,125,511
8343,text,161,491,264,20,37.png,1024,1430,425,511
8344,text,581,495,36,16,37.png,1024,1430,617,511
8345,text,735,493,56,18,37.png,1024,1430,791,511
8346,text,861,493,56,20,37.png,1024,1430,917,513
8347,text,80,1038,96,24,37.png,1024,1430,176,1062
8348,text,227,1039,124,20,37.png,1024,1430,351,1059
8349,text,399,1039,106,20,37.png,1024,1430,505,1059
8350,text,583,1039,64,20,37.png,1024,1430,647,1059
8351,text,747,1037,120,20,37.png,1024,1430,867,1057
8352,text,800,1064,64,24,37.png,1024,1430,864,1088
8353,text,281,1093,56,20,37.png,1024,1430,337,1113
8354,text,445,1093,24,20,37.png,1024,1430,469,1113
8355,text,619,1093,48,20,37.png,1024,1430,667,1113
8356,text,81,1173,406,18,37.png,1024,1430,487,1191
8357,text,839,1174,36,20,37.png,1024,1430,875,1194
8358,text,79,1189,244,20,37.png,1024,1430,323,1209
8359,text,833,1193,24,14,37.png,1024,1430,857,1207
8360,text,897,1195,24,18,37.png,1024,1430,921,1213
8361,text,69,1271,56,16,37.png,1024,1430,125,1287
8362,text,137,1271,22,16,37.png,1024,1430,159,1287
8363,text,167,1271,50,16,37.png,1024,1430,217,1287
8364,text,253,1271,96,16,37.png,1024,1430,349,1287
8365,text,357,1271,126,14,37.png,1024,1430,483,1285
8366,text,495,1269,132,16,37.png,1024,1430,627,1285
8367,text,641,1269,82,16,37.png,1024,1430,723,1285
8368,text,731,1269,30,16,37.png,1024,1430,761,1285
8369,text,771,1267,104,16,37.png,1024,1430,875,1283
8370,text,69,1285,406,18,37.png,1024,1430,475,1303
8371,text,481,1285,72,16,37.png,1024,1430,553,1301
8372,text,561,1283,112,18,37.png,1024,1430,673,1301
8373,text,681,1285,64,16,37.png,1024,1430,745,1301
8374,text,753,1283,122,16,37.png,1024,1430,875,1299
8375,text,291,1303,26,14,37.png,1024,1430,317,1317
8376,text,325,1301,118,16,37.png,1024,1430,443,1317
8377,text,451,1301,38,16,37.png,1024,1430,489,1317
8378,text,495,1301,182,18,37.png,1024,1430,677,1319
8379,text,921,493,26,17,37.png,1024,1430,947,510
8380,text,220,1269,25,17,37.png,1024,1430,245,1286
8381,text,132,96,86,24,37_contrasted.png,1024,1430,218,120
8382,text,224,96,92,24,37_contrasted.png,1024,1430,316,120
8383,text,322,96,34,24,37_contrasted.png,1024,1430,356,120
8384,text,368,96,56,24,37_contrasted.png,1024,1430,424,120
8385,text,604,83,354,33,37_contrasted.png,1024,1430,958,116
8386,text,477,133,100,20,37_contrasted.png,1024,1430,577,153
8387,text,40,178,178,25,37_contrasted.png,1024,1430,218,203
8388,text,470,182,178,26,37_contrasted.png,1024,1430,648,208
8389,text,654,184,76,24,37_contrasted.png,1024,1430,730,208
8390,text,40,202,128,24,37_contrasted.png,1024,1430,168,226
8391,text,41,227,126,20,37_contrasted.png,1024,1430,167,247
8392,text,471,219,256,20,37_contrasted.png,1024,1430,727,239
8393,text,472,240,248,24,37_contrasted.png,1024,1430,720,264
8394,text,470,266,118,24,37_contrasted.png,1024,1430,588,290
8395,text,469,291,44,20,37_contrasted.png,1024,1430,513,311
8396,text,529,291,140,20,37_contrasted.png,1024,1430,669,311
8397,text,57,361,50,20,37_contrasted.png,1024,1430,107,381
8398,text,186,356,110,24,37_contrasted.png,1024,1430,296,380
8399,text,333,361,118,20,37_contrasted.png,1024,1430,451,381
8400,text,474,358,152,24,37_contrasted.png,1024,1430,626,382
8401,text,659,359,54,20,37_contrasted.png,1024,1430,713,379
8402,text,723,359,42,20,37_contrasted.png,1024,1430,765,379
8403,text,821,359,54,20,37_contrasted.png,1024,1430,875,379
8404,text,885,359,38,20,37_contrasted.png,1024,1430,923,379
8405,text,42,389,90,20,37_contrasted.png,1024,1430,132,409
8406,text,208,388,74,24,37_contrasted.png,1024,1430,282,412
8407,text,368,388,62,24,37_contrasted.png,1024,1430,430,412
8408,text,487,387,114,20,37_contrasted.png,1024,1430,601,407
8409,text,647,387,134,20,37_contrasted.png,1024,1430,781,407
8410,text,807,387,106,20,37_contrasted.png,1024,1430,913,407
8411,text,37,433,102,20,37_contrasted.png,1024,1430,139,453
8412,text,270,430,100,24,37_contrasted.png,1024,1430,370,454
8413,text,489,431,36,20,37_contrasted.png,1024,1430,525,451
8414,text,549,431,48,20,37_contrasted.png,1024,1430,597,451
8415,text,631,431,38,18,37_contrasted.png,1024,1430,669,449
8416,text,685,429,100,20,37_contrasted.png,1024,1430,785,449
8417,text,815,429,92,20,37_contrasted.png,1024,1430,907,449
8418,text,139,467,58,20,37_contrasted.png,1024,1430,197,487
8419,text,33,491,92,20,37_contrasted.png,1024,1430,125,511
8420,text,161,491,264,20,37_contrasted.png,1024,1430,425,511
8421,text,581,495,36,16,37_contrasted.png,1024,1430,617,511
8422,text,735,493,56,18,37_contrasted.png,1024,1430,791,511
8423,text,861,493,56,20,37_contrasted.png,1024,1430,917,513
8424,text,80,1038,96,24,37_contrasted.png,1024,1430,176,1062
8425,text,227,1039,124,20,37_contrasted.png,1024,1430,351,1059
8426,text,399,1039,106,20,37_contrasted.png,1024,1430,505,1059
8427,text,583,1039,64,20,37_contrasted.png,1024,1430,647,1059
8428,text,747,1037,120,20,37_contrasted.png,1024,1430,867,1057
8429,text,800,1064,64,24,37_contrasted.png,1024,1430,864,1088
8430,text,281,1093,56,20,37_contrasted.png,1024,1430,337,1113
8431,text,445,1093,24,20,37_contrasted.png,1024,1430,469,1113
8432,text,619,1093,48,20,37_contrasted.png,1024,1430,667,1113
8433,text,81,1173,406,18,37_contrasted.png,1024,1430,487,1191
8434,text,839,1174,36,20,37_contrasted.png,1024,1430,875,1194
8435,text,79,1189,244,20,37_contrasted.png,1024,1430,323,1209
8436,text,833,1193,24,14,37_contrasted.png,1024,1430,857,1207
8437,text,897,1195,24,18,37_contrasted.png,1024,1430,921,1213
8438,text,69,1271,56,16,37_contrasted.png,1024,1430,125,1287
8439,text,137,1271,22,16,37_contrasted.png,1024,1430,159,1287
8440,text,167,1271,50,16,37_contrasted.png,1024,1430,217,1287
8441,text,253,1271,96,16,37_contrasted.png,1024,1430,349,1287
8442,text,357,1271,126,14,37_contrasted.png,1024,1430,483,1285
8443,text,495,1269,132,16,37_contrasted.png,1024,1430,627,1285
8444,text,641,1269,82,16,37_contrasted.png,1024,1430,723,1285
8445,text,731,1269,30,16,37_contrasted.png,1024,1430,761,1285
8446,text,771,1267,104,16,37_contrasted.png,1024,1430,875,1283
8447,text,69,1285,406,18,37_contrasted.png,1024,1430,475,1303
8448,text,481,1285,72,16,37_contrasted.png,1024,1430,553,1301
8449,text,561,1283,112,18,37_contrasted.png,1024,1430,673,1301
8450,text,681,1285,64,16,37_contrasted.png,1024,1430,745,1301
8451,text,753,1283,122,16,37_contrasted.png,1024,1430,875,1299
8452,text,291,1303,26,14,37_contrasted.png,1024,1430,317,1317
8453,text,325,1301,118,16,37_contrasted.png,1024,1430,443,1317
8454,text,451,1301,38,16,37_contrasted.png,1024,1430,489,1317
8455,text,495,1301,182,18,37_contrasted.png,1024,1430,677,1319
8456,text,921,493,26,17,37_contrasted.png,1024,1430,947,510
8457,text,220,1269,25,17,37_contrasted.png,1024,1430,245,1286
8458,text,132,96,86,24,37_denoise.png,1024,1430,218,120
8459,text,224,96,92,24,37_denoise.png,1024,1430,316,120
8460,text,322,96,34,24,37_denoise.png,1024,1430,356,120
8461,text,368,96,56,24,37_denoise.png,1024,1430,424,120
8462,text,604,83,354,33,37_denoise.png,1024,1430,958,116
8463,text,477,133,100,20,37_denoise.png,1024,1430,577,153
8464,text,40,178,178,25,37_denoise.png,1024,1430,218,203
8465,text,470,182,178,26,37_denoise.png,1024,1430,648,208
8466,text,654,184,76,24,37_denoise.png,1024,1430,730,208
8467,text,40,202,128,24,37_denoise.png,1024,1430,168,226
8468,text,41,227,126,20,37_denoise.png,1024,1430,167,247
8469,text,471,219,256,20,37_denoise.png,1024,1430,727,239
8470,text,472,240,248,24,37_denoise.png,1024,1430,720,264
8471,text,470,266,118,24,37_denoise.png,1024,1430,588,290
8472,text,469,291,44,20,37_denoise.png,1024,1430,513,311
8473,text,529,291,140,20,37_denoise.png,1024,1430,669,311
8474,text,57,361,50,20,37_denoise.png,1024,1430,107,381
8475,text,186,356,110,24,37_denoise.png,1024,1430,296,380
8476,text,333,361,118,20,37_denoise.png,1024,1430,451,381
8477,text,474,358,152,24,37_denoise.png,1024,1430,626,382
8478,text,659,359,54,20,37_denoise.png,1024,1430,713,379
8479,text,723,359,42,20,37_denoise.png,1024,1430,765,379
8480,text,821,359,54,20,37_denoise.png,1024,1430,875,379
8481,text,885,359,38,20,37_denoise.png,1024,1430,923,379
8482,text,42,389,90,20,37_denoise.png,1024,1430,132,409
8483,text,208,388,74,24,37_denoise.png,1024,1430,282,412
8484,text,368,388,62,24,37_denoise.png,1024,1430,430,412
8485,text,487,387,114,20,37_denoise.png,1024,1430,601,407
8486,text,647,387,134,20,37_denoise.png,1024,1430,781,407
8487,text,807,387,106,20,37_denoise.png,1024,1430,913,407
8488,text,37,433,102,20,37_denoise.png,1024,1430,139,453
8489,text,270,430,100,24,37_denoise.png,1024,1430,370,454
8490,text,489,431,36,20,37_denoise.png,1024,1430,525,451
8491,text,549,431,48,20,37_denoise.png,1024,1430,597,451
8492,text,631,431,38,18,37_denoise.png,1024,1430,669,449
8493,text,685,429,100,20,37_denoise.png,1024,1430,785,449
8494,text,815,429,92,20,37_denoise.png,1024,1430,907,449
8495,text,139,467,58,20,37_denoise.png,1024,1430,197,487
8496,text,33,491,92,20,37_denoise.png,1024,1430,125,511
8497,text,161,491,264,20,37_denoise.png,1024,1430,425,511
8498,text,581,495,36,16,37_denoise.png,1024,1430,617,511
8499,text,735,493,56,18,37_denoise.png,1024,1430,791,511
8500,text,861,493,56,20,37_denoise.png,1024,1430,917,513
8501,text,80,1038,96,24,37_denoise.png,1024,1430,176,1062
8502,text,227,1039,124,20,37_denoise.png,1024,1430,351,1059
8503,text,399,1039,106,20,37_denoise.png,1024,1430,505,1059
8504,text,583,1039,64,20,37_denoise.png,1024,1430,647,1059
8505,text,747,1037,120,20,37_denoise.png,1024,1430,867,1057
8506,text,800,1064,64,24,37_denoise.png,1024,1430,864,1088
8507,text,281,1093,56,20,37_denoise.png,1024,1430,337,1113
8508,text,445,1093,24,20,37_denoise.png,1024,1430,469,1113
8509,text,619,1093,48,20,37_denoise.png,1024,1430,667,1113
8510,text,81,1173,406,18,37_denoise.png,1024,1430,487,1191
8511,text,839,1174,36,20,37_denoise.png,1024,1430,875,1194
8512,text,79,1189,244,20,37_denoise.png,1024,1430,323,1209
8513,text,833,1193,24,14,37_denoise.png,1024,1430,857,1207
8514,text,897,1195,24,18,37_denoise.png,1024,1430,921,1213
8515,text,69,1271,56,16,37_denoise.png,1024,1430,125,1287
8516,text,137,1271,22,16,37_denoise.png,1024,1430,159,1287
8517,text,167,1271,50,16,37_denoise.png,1024,1430,217,1287
8518,text,253,1271,96,16,37_denoise.png,1024,1430,349,1287
8519,text,357,1271,126,14,37_denoise.png,1024,1430,483,1285
8520,text,495,1269,132,16,37_denoise.png,1024,1430,627,1285
8521,text,641,1269,82,16,37_denoise.png,1024,1430,723,1285
8522,text,731,1269,30,16,37_denoise.png,1024,1430,761,1285
8523,text,771,1267,104,16,37_denoise.png,1024,1430,875,1283
8524,text,69,1285,406,18,37_denoise.png,1024,1430,475,1303
8525,text,481,1285,72,16,37_denoise.png,1024,1430,553,1301
8526,text,561,1283,112,18,37_denoise.png,1024,1430,673,1301
8527,text,681,1285,64,16,37_denoise.png,1024,1430,745,1301
8528,text,753,1283,122,16,37_denoise.png,1024,1430,875,1299
8529,text,291,1303,26,14,37_denoise.png,1024,1430,317,1317
8530,text,325,1301,118,16,37_denoise.png,1024,1430,443,1317
8531,text,451,1301,38,16,37_denoise.png,1024,1430,489,1317
8532,text,495,1301,182,18,37_denoise.png,1024,1430,677,1319
8533,text,921,493,26,17,37_denoise.png,1024,1430,947,510
8534,text,220,1269,25,17,37_denoise.png,1024,1430,245,1286
8535,text,132,96,86,24,37_median.png,1024,1430,218,120
8536,text,224,96,92,24,37_median.png,1024,1430,316,120
8537,text,322,96,34,24,37_median.png,1024,1430,356,120
8538,text,368,96,56,24,37_median.png,1024,1430,424,120
8539,text,604,83,354,33,37_median.png,1024,1430,958,116
8540,text,477,133,100,20,37_median.png,1024,1430,577,153
8541,text,40,178,178,25,37_median.png,1024,1430,218,203
8542,text,470,182,178,26,37_median.png,1024,1430,648,208
8543,text,654,184,76,24,37_median.png,1024,1430,730,208
8544,text,40,202,128,24,37_median.png,1024,1430,168,226
8545,text,41,227,126,20,37_median.png,1024,1430,167,247
8546,text,471,219,256,20,37_median.png,1024,1430,727,239
8547,text,472,240,248,24,37_median.png,1024,1430,720,264
8548,text,470,266,118,24,37_median.png,1024,1430,588,290
8549,text,469,291,44,20,37_median.png,1024,1430,513,311
8550,text,529,291,140,20,37_median.png,1024,1430,669,311
8551,text,57,361,50,20,37_median.png,1024,1430,107,381
8552,text,186,356,110,24,37_median.png,1024,1430,296,380
8553,text,333,361,118,20,37_median.png,1024,1430,451,381
8554,text,474,358,152,24,37_median.png,1024,1430,626,382
8555,text,659,359,54,20,37_median.png,1024,1430,713,379
8556,text,723,359,42,20,37_median.png,1024,1430,765,379
8557,text,821,359,54,20,37_median.png,1024,1430,875,379
8558,text,885,359,38,20,37_median.png,1024,1430,923,379
8559,text,42,389,90,20,37_median.png,1024,1430,132,409
8560,text,208,388,74,24,37_median.png,1024,1430,282,412
8561,text,368,388,62,24,37_median.png,1024,1430,430,412
8562,text,487,387,114,20,37_median.png,1024,1430,601,407
8563,text,647,387,134,20,37_median.png,1024,1430,781,407
8564,text,807,387,106,20,37_median.png,1024,1430,913,407
8565,text,37,433,102,20,37_median.png,1024,1430,139,453
8566,text,270,430,100,24,37_median.png,1024,1430,370,454
8567,text,489,431,36,20,37_median.png,1024,1430,525,451
8568,text,549,431,48,20,37_median.png,1024,1430,597,451
8569,text,631,431,38,18,37_median.png,1024,1430,669,449
8570,text,685,429,100,20,37_median.png,1024,1430,785,449
8571,text,815,429,92,20,37_median.png,1024,1430,907,449
8572,text,139,467,58,20,37_median.png,1024,1430,197,487
8573,text,33,491,92,20,37_median.png,1024,1430,125,511
8574,text,161,491,264,20,37_median.png,1024,1430,425,511
8575,text,581,495,36,16,37_median.png,1024,1430,617,511
8576,text,735,493,56,18,37_median.png,1024,1430,791,511
8577,text,861,493,56,20,37_median.png,1024,1430,917,513
8578,text,80,1038,96,24,37_median.png,1024,1430,176,1062
8579,text,227,1039,124,20,37_median.png,1024,1430,351,1059
8580,text,399,1039,106,20,37_median.png,1024,1430,505,1059
8581,text,583,1039,64,20,37_median.png,1024,1430,647,1059
8582,text,747,1037,120,20,37_median.png,1024,1430,867,1057
8583,text,800,1064,64,24,37_median.png,1024,1430,864,1088
8584,text,281,1093,56,20,37_median.png,1024,1430,337,1113
8585,text,445,1093,24,20,37_median.png,1024,1430,469,1113
8586,text,619,1093,48,20,37_median.png,1024,1430,667,1113
8587,text,81,1173,406,18,37_median.png,1024,1430,487,1191
8588,text,839,1174,36,20,37_median.png,1024,1430,875,1194
8589,text,79,1189,244,20,37_median.png,1024,1430,323,1209
8590,text,833,1193,24,14,37_median.png,1024,1430,857,1207
8591,text,897,1195,24,18,37_median.png,1024,1430,921,1213
8592,text,69,1271,56,16,37_median.png,1024,1430,125,1287
8593,text,137,1271,22,16,37_median.png,1024,1430,159,1287
8594,text,167,1271,50,16,37_median.png,1024,1430,217,1287
8595,text,253,1271,96,16,37_median.png,1024,1430,349,1287
8596,text,357,1271,126,14,37_median.png,1024,1430,483,1285
8597,text,495,1269,132,16,37_median.png,1024,1430,627,1285
8598,text,641,1269,82,16,37_median.png,1024,1430,723,1285
8599,text,731,1269,30,16,37_median.png,1024,1430,761,1285
8600,text,771,1267,104,16,37_median.png,1024,1430,875,1283
8601,text,69,1285,406,18,37_median.png,1024,1430,475,1303
8602,text,481,1285,72,16,37_median.png,1024,1430,553,1301
8603,text,561,1283,112,18,37_median.png,1024,1430,673,1301
8604,text,681,1285,64,16,37_median.png,1024,1430,745,1301
8605,text,753,1283,122,16,37_median.png,1024,1430,875,1299
8606,text,291,1303,26,14,37_median.png,1024,1430,317,1317
8607,text,325,1301,118,16,37_median.png,1024,1430,443,1317
8608,text,451,1301,38,16,37_median.png,1024,1430,489,1317
8609,text,495,1301,182,18,37_median.png,1024,1430,677,1319
8610,text,921,493,26,17,37_median.png,1024,1430,947,510
8611,text,220,1269,25,17,37_median.png,1024,1430,245,1286
8612,text,67,12,144,21,38.png,1024,1413,211,33
8613,text,595,153,174,36,38.png,1024,1413,769,189
8614,text,471,189,424,40,38.png,1024,1413,895,229
8615,text,533,225,294,40,38.png,1024,1413,827,265
8616,text,588,260,180,36,38.png,1024,1413,768,296
8617,text,503,297,64,36,38.png,1024,1413,567,333
8618,text,583,295,270,38,38.png,1024,1413,853,333
8619,text,474,356,220,32,38.png,1024,1413,694,388
8620,text,706,358,240,30,38.png,1024,1413,946,388
8621,text,95,445,282,38,38.png,1024,1413,377,483
8622,text,596,456,82,32,38.png,1024,1413,678,488
8623,text,802,456,86,32,38.png,1024,1413,888,488
8624,text,438,472,60,30,38.png,1024,1413,498,502
8625,text,160,488,154,32,38.png,1024,1413,314,520
8626,text,531,499,212,36,38.png,1024,1413,743,535
8627,text,765,501,164,36,38.png,1024,1413,929,537
8628,text,57,561,196,36,38.png,1024,1413,253,597
8629,text,264,564,68,32,38.png,1024,1413,332,596
8630,text,592,566,78,32,38.png,1024,1413,670,598
8631,text,765,565,150,38,38.png,1024,1413,915,603
8632,text,58,614,192,32,38.png,1024,1413,250,646
8633,text,57,646,157,36,38.png,1024,1413,214,682
8634,text,592,634,76,32,38.png,1024,1413,668,666
8635,text,765,630,148,41,38.png,1024,1413,913,671
8636,text,55,695,310,36,38.png,1024,1413,365,731
8637,text,448,690,28,47,38.png,1024,1413,476,737
8638,text,590,698,78,32,38.png,1024,1413,668,730
8639,text,763,699,150,36,38.png,1024,1413,913,735
8640,text,562,748,134,30,38.png,1024,1413,696,778
8641,text,757,747,164,36,38.png,1024,1413,921,783
8642,text,600,814,56,28,38.png,1024,1413,656,842
8643,text,763,808,148,42,38.png,1024,1413,911,850
8644,text,554,878,146,30,38.png,1024,1413,700,908
8645,text,755,877,166,36,38.png,1024,1413,921,913
8646,text,40,934,466,26,38.png,1024,1413,506,960
8647,text,520,938,424,26,38.png,1024,1413,944,964
8648,text,40,972,344,24,38.png,1024,1413,384,996
8649,text,156,1302,524,32,38.png,1024,1413,680,1334
8650,text,688,1312,116,24,38.png,1024,1413,804,1336
8651,text,194,1330,208,22,38.png,1024,1413,402,1352
8652,text,407,1333,220,22,38.png,1024,1413,627,1355
8653,text,401,1353,213,25,38.png,1024,1413,614,1378
8654,text,612,1356,190,30,38.png,1024,1413,802,1386
8655,text,444,558,38,47,38.png,1024,1413,482,605
8656,text,446,622,34,47,38.png,1024,1413,480,669
8657,text,629,1335,139,24,38.png,1024,1413,768,1359
8658,text,67,12,144,21,38_contrasted.png,1024,1413,211,33
8659,text,595,153,174,36,38_contrasted.png,1024,1413,769,189
8660,text,471,189,424,40,38_contrasted.png,1024,1413,895,229
8661,text,533,225,294,40,38_contrasted.png,1024,1413,827,265
8662,text,588,260,180,36,38_contrasted.png,1024,1413,768,296
8663,text,503,297,64,36,38_contrasted.png,1024,1413,567,333
8664,text,583,295,270,38,38_contrasted.png,1024,1413,853,333
8665,text,474,356,220,32,38_contrasted.png,1024,1413,694,388
8666,text,706,358,240,30,38_contrasted.png,1024,1413,946,388
8667,text,95,445,282,38,38_contrasted.png,1024,1413,377,483
8668,text,596,456,82,32,38_contrasted.png,1024,1413,678,488
8669,text,802,456,86,32,38_contrasted.png,1024,1413,888,488
8670,text,438,472,60,30,38_contrasted.png,1024,1413,498,502
8671,text,160,488,154,32,38_contrasted.png,1024,1413,314,520
8672,text,531,499,212,36,38_contrasted.png,1024,1413,743,535
8673,text,765,501,164,36,38_contrasted.png,1024,1413,929,537
8674,text,57,561,196,36,38_contrasted.png,1024,1413,253,597
8675,text,264,564,68,32,38_contrasted.png,1024,1413,332,596
8676,text,592,566,78,32,38_contrasted.png,1024,1413,670,598
8677,text,765,565,150,38,38_contrasted.png,1024,1413,915,603
8678,text,58,614,192,32,38_contrasted.png,1024,1413,250,646
8679,text,57,646,157,36,38_contrasted.png,1024,1413,214,682
8680,text,592,634,76,32,38_contrasted.png,1024,1413,668,666
8681,text,765,630,148,41,38_contrasted.png,1024,1413,913,671
8682,text,55,695,310,36,38_contrasted.png,1024,1413,365,731
8683,text,448,690,28,47,38_contrasted.png,1024,1413,476,737
8684,text,590,698,78,32,38_contrasted.png,1024,1413,668,730
8685,text,763,699,150,36,38_contrasted.png,1024,1413,913,735
8686,text,562,748,134,30,38_contrasted.png,1024,1413,696,778
8687,text,757,747,164,36,38_contrasted.png,1024,1413,921,783
8688,text,600,814,56,28,38_contrasted.png,1024,1413,656,842
8689,text,763,808,148,42,38_contrasted.png,1024,1413,911,850
8690,text,554,878,146,30,38_contrasted.png,1024,1413,700,908
8691,text,755,877,166,36,38_contrasted.png,1024,1413,921,913
8692,text,40,934,466,26,38_contrasted.png,1024,1413,506,960
8693,text,520,938,424,26,38_contrasted.png,1024,1413,944,964
8694,text,40,972,344,24,38_contrasted.png,1024,1413,384,996
8695,text,156,1302,524,32,38_contrasted.png,1024,1413,680,1334
8696,text,688,1312,116,24,38_contrasted.png,1024,1413,804,1336
8697,text,194,1330,208,22,38_contrasted.png,1024,1413,402,1352
8698,text,407,1333,220,22,38_contrasted.png,1024,1413,627,1355
8699,text,401,1353,213,25,38_contrasted.png,1024,1413,614,1378
8700,text,612,1356,190,30,38_contrasted.png,1024,1413,802,1386
8701,text,444,558,38,47,38_contrasted.png,1024,1413,482,605
8702,text,446,622,34,47,38_contrasted.png,1024,1413,480,669
8703,text,629,1335,139,24,38_contrasted.png,1024,1413,768,1359
8704,text,67,12,144,21,38_denoise.png,1024,1413,211,33
8705,text,595,153,174,36,38_denoise.png,1024,1413,769,189
8706,text,471,189,424,40,38_denoise.png,1024,1413,895,229
8707,text,533,225,294,40,38_denoise.png,1024,1413,827,265
8708,text,588,260,180,36,38_denoise.png,1024,1413,768,296
8709,text,503,297,64,36,38_denoise.png,1024,1413,567,333
8710,text,583,295,270,38,38_denoise.png,1024,1413,853,333
8711,text,474,356,220,32,38_denoise.png,1024,1413,694,388
8712,text,706,358,240,30,38_denoise.png,1024,1413,946,388
8713,text,95,445,282,38,38_denoise.png,1024,1413,377,483
8714,text,596,456,82,32,38_denoise.png,1024,1413,678,488
8715,text,802,456,86,32,38_denoise.png,1024,1413,888,488
8716,text,438,472,60,30,38_denoise.png,1024,1413,498,502
8717,text,160,488,154,32,38_denoise.png,1024,1413,314,520
8718,text,531,499,212,36,38_denoise.png,1024,1413,743,535
8719,text,765,501,164,36,38_denoise.png,1024,1413,929,537
8720,text,57,561,196,36,38_denoise.png,1024,1413,253,597
8721,text,264,564,68,32,38_denoise.png,1024,1413,332,596
8722,text,592,566,78,32,38_denoise.png,1024,1413,670,598
8723,text,765,565,150,38,38_denoise.png,1024,1413,915,603
8724,text,58,614,192,32,38_denoise.png,1024,1413,250,646
8725,text,57,646,157,36,38_denoise.png,1024,1413,214,682
8726,text,592,634,76,32,38_denoise.png,1024,1413,668,666
8727,text,765,630,148,41,38_denoise.png,1024,1413,913,671
8728,text,55,695,310,36,38_denoise.png,1024,1413,365,731
8729,text,448,690,28,47,38_denoise.png,1024,1413,476,737
8730,text,590,698,78,32,38_denoise.png,1024,1413,668,730
8731,text,763,699,150,36,38_denoise.png,1024,1413,913,735
8732,text,562,748,134,30,38_denoise.png,1024,1413,696,778
8733,text,757,747,164,36,38_denoise.png,1024,1413,921,783
8734,text,600,814,56,28,38_denoise.png,1024,1413,656,842
8735,text,763,808,148,42,38_denoise.png,1024,1413,911,850
8736,text,554,878,146,30,38_denoise.png,1024,1413,700,908
8737,text,755,877,166,36,38_denoise.png,1024,1413,921,913
8738,text,40,934,466,26,38_denoise.png,1024,1413,506,960
8739,text,520,938,424,26,38_denoise.png,1024,1413,944,964
8740,text,40,972,344,24,38_denoise.png,1024,1413,384,996
8741,text,156,1302,524,32,38_denoise.png,1024,1413,680,1334
8742,text,688,1312,116,24,38_denoise.png,1024,1413,804,1336
8743,text,194,1330,208,22,38_denoise.png,1024,1413,402,1352
8744,text,407,1333,220,22,38_denoise.png,1024,1413,627,1355
8745,text,401,1353,213,25,38_denoise.png,1024,1413,614,1378
8746,text,612,1356,190,30,38_denoise.png,1024,1413,802,1386
8747,text,444,558,38,47,38_denoise.png,1024,1413,482,605
8748,text,446,622,34,47,38_denoise.png,1024,1413,480,669
8749,text,629,1335,139,24,38_denoise.png,1024,1413,768,1359
8750,text,67,12,144,21,38_median.png,1024,1413,211,33
8751,text,595,153,174,36,38_median.png,1024,1413,769,189
8752,text,471,189,424,40,38_median.png,1024,1413,895,229
8753,text,533,225,294,40,38_median.png,1024,1413,827,265
8754,text,588,260,180,36,38_median.png,1024,1413,768,296
8755,text,503,297,64,36,38_median.png,1024,1413,567,333
8756,text,583,295,270,38,38_median.png,1024,1413,853,333
8757,text,474,356,220,32,38_median.png,1024,1413,694,388
8758,text,706,358,240,30,38_median.png,1024,1413,946,388
8759,text,95,445,282,38,38_median.png,1024,1413,377,483
8760,text,596,456,82,32,38_median.png,1024,1413,678,488
8761,text,802,456,86,32,38_median.png,1024,1413,888,488
8762,text,438,472,60,30,38_median.png,1024,1413,498,502
8763,text,160,488,154,32,38_median.png,1024,1413,314,520
8764,text,531,499,212,36,38_median.png,1024,1413,743,535
8765,text,765,501,164,36,38_median.png,1024,1413,929,537
8766,text,57,561,196,36,38_median.png,1024,1413,253,597
8767,text,264,564,68,32,38_median.png,1024,1413,332,596
8768,text,592,566,78,32,38_median.png,1024,1413,670,598
8769,text,765,565,150,38,38_median.png,1024,1413,915,603
8770,text,58,614,192,32,38_median.png,1024,1413,250,646
8771,text,57,646,157,36,38_median.png,1024,1413,214,682
8772,text,592,634,76,32,38_median.png,1024,1413,668,666
8773,text,765,630,148,41,38_median.png,1024,1413,913,671
8774,text,55,695,310,36,38_median.png,1024,1413,365,731
8775,text,448,690,28,47,38_median.png,1024,1413,476,737
8776,text,590,698,78,32,38_median.png,1024,1413,668,730
8777,text,763,699,150,36,38_median.png,1024,1413,913,735
8778,text,562,748,134,30,38_median.png,1024,1413,696,778
8779,text,757,747,164,36,38_median.png,1024,1413,921,783
8780,text,600,814,56,28,38_median.png,1024,1413,656,842
8781,text,763,808,148,42,38_median.png,1024,1413,911,850
8782,text,554,878,146,30,38_median.png,1024,1413,700,908
8783,text,755,877,166,36,38_median.png,1024,1413,921,913
8784,text,40,934,466,26,38_median.png,1024,1413,506,960
8785,text,520,938,424,26,38_median.png,1024,1413,944,964
8786,text,40,972,344,24,38_median.png,1024,1413,384,996
8787,text,156,1302,524,32,38_median.png,1024,1413,680,1334
8788,text,688,1312,116,24,38_median.png,1024,1413,804,1336
8789,text,194,1330,208,22,38_median.png,1024,1413,402,1352
8790,text,407,1333,220,22,38_median.png,1024,1413,627,1355
8791,text,401,1353,213,25,38_median.png,1024,1413,614,1378
8792,text,612,1356,190,30,38_median.png,1024,1413,802,1386
8793,text,444,558,38,47,38_median.png,1024,1413,482,605
8794,text,446,622,34,47,38_median.png,1024,1413,480,669
8795,text,629,1335,139,24,38_median.png,1024,1413,768,1359
8796,text,247,63,173,54,39.png,1024,1430,420,117
8797,text,465,71,345,42,39.png,1024,1430,810,113
8798,text,277,119,116,14,39.png,1024,1430,393,133
8799,text,466,108,340,24,39.png,1024,1430,806,132
8800,text,63,197,98,16,39.png,1024,1430,161,213
8801,text,213,199,30,14,39.png,1024,1430,243,213
8802,text,375,201,40,14,39.png,1024,1430,415,215
8803,text,573,215,84,20,39.png,1024,1430,657,235
8804,text,59,227,62,20,39.png,1024,1430,121,247
8805,text,183,229,62,20,39.png,1024,1430,245,249
8806,text,341,231,106,21,39.png,1024,1430,447,252
8807,text,65,275,64,14,39.png,1024,1430,129,289
8808,text,301,275,92,16,39.png,1024,1430,393,291
8809,text,571,289,30,18,39.png,1024,1430,601,307
8810,text,609,289,124,20,39.png,1024,1430,733,309
8811,text,63,345,56,16,39.png,1024,1430,119,361
8812,text,133,343,78,18,39.png,1024,1430,211,361
8813,text,59,375,264,38,39.png,1024,1430,323,413
8814,text,55,445,64,14,39.png,1024,1430,119,459
8815,text,173,445,76,16,39.png,1024,1430,249,461
8816,text,435,447,24,14,39.png,1024,1430,459,461
8817,text,536,447,108,16,39.png,1024,1430,644,463
8818,text,715,449,40,14,39.png,1024,1430,755,463
8819,text,777,447,52,16,39.png,1024,1430,829,463
8820,text,842,446,75,18,39.png,1024,1430,917,464
8821,text,51,465,54,20,39.png,1024,1430,105,485
8822,text,141,465,148,20,39.png,1024,1430,289,485
8823,text,439,469,50,18,39.png,1024,1430,489,487
8824,text,532,469,93,20,39.png,1024,1430,625,489
8825,text,737,469,34,20,39.png,1024,1430,771,489
8826,text,861,469,62,20,39.png,1024,1430,923,489
8827,text,47,1067,34,14,39.png,1024,1430,81,1081
8828,text,139,1067,32,14,39.png,1024,1430,171,1081
8829,text,207,1067,32,14,39.png,1024,1430,239,1081
8830,text,293,1067,32,14,39.png,1024,1430,325,1081
8831,text,415,1067,54,14,39.png,1024,1430,469,1081
8832,text,535,1067,62,16,39.png,1024,1430,597,1083
8833,text,686,1066,47,18,39.png,1024,1430,733,1084
8834,text,797,1061,104,20,39.png,1024,1430,901,1081
8835,text,111,1099,64,20,39.png,1024,1430,175,1119
8836,text,207,1101,34,18,39.png,1024,1430,241,1119
8837,text,277,1101,50,18,39.png,1024,1430,327,1119
8838,text,395,1101,62,18,39.png,1024,1430,457,1119
8839,text,545,1101,60,18,39.png,1024,1430,605,1119
8840,text,695,1103,40,16,39.png,1024,1430,735,1119
8841,text,841,1103,62,16,39.png,1024,1430,903,1119
8842,text,357,1136,158,20,39.png,1024,1430,515,1156
8843,text,551,1133,78,20,39.png,1024,1430,629,1153
8844,text,749,1137,54,18,39.png,1024,1430,803,1155
8845,text,855,1135,60,18,39.png,1024,1430,915,1153
8846,text,49,1159,38,16,39.png,1024,1430,87,1175
8847,text,111,1157,60,18,39.png,1024,1430,171,1175
8848,text,277,1157,48,18,39.png,1024,1430,325,1175
8849,text,39,1186,294,21,39.png,1024,1430,333,1207
8850,text,337,1191,24,14,39.png,1024,1430,361,1205
8851,text,359,1187,96,20,39.png,1024,1430,455,1207
8852,text,40,1210,488,24,39.png,1024,1430,528,1234
8853,text,65,1286,192,17,39.png,1024,1430,257,1303
8854,text,64,1303,105,14,39.png,1024,1430,169,1317
8855,text,177,1305,168,14,39.png,1024,1430,345,1319
8856,text,353,1305,24,14,39.png,1024,1430,377,1319
8857,text,383,1305,130,14,39.png,1024,1430,513,1319
8858,text,521,1305,118,16,39.png,1024,1430,639,1321
8859,text,647,1307,44,14,39.png,1024,1430,691,1321
8860,text,695,1307,150,16,39.png,1024,1430,845,1323
8861,text,65,1319,184,14,39.png,1024,1430,249,1333
8862,text,257,1319,88,16,39.png,1024,1430,345,1335
8863,text,353,1319,102,16,39.png,1024,1430,455,1335
8864,text,111,1333,68,14,39.png,1024,1430,179,1347
8865,text,187,1333,116,16,39.png,1024,1430,303,1349
8866,text,309,1335,146,14,39.png,1024,1430,455,1349
8867,text,65,1349,128,14,39.png,1024,1430,193,1363
8868,text,65,1365,110,14,39.png,1024,1430,175,1379
8869,text,839,1193,31,14,39.png,1024,1430,870,1207
8870,text,64,1334,45,14,39.png,1024,1430,109,1348
8871,text,887,1185,16,21,39.png,1024,1430,903,1206
8872,text,42,1099,18,19,39.png,1024,1430,60,1118
8873,text,247,63,173,54,39_contrasted.png,1024,1430,420,117
8874,text,465,71,345,42,39_contrasted.png,1024,1430,810,113
8875,text,277,119,116,14,39_contrasted.png,1024,1430,393,133
8876,text,466,108,340,24,39_contrasted.png,1024,1430,806,132
8877,text,63,197,98,16,39_contrasted.png,1024,1430,161,213
8878,text,213,199,30,14,39_contrasted.png,1024,1430,243,213
8879,text,375,201,40,14,39_contrasted.png,1024,1430,415,215
8880,text,573,215,84,20,39_contrasted.png,1024,1430,657,235
8881,text,59,227,62,20,39_contrasted.png,1024,1430,121,247
8882,text,183,229,62,20,39_contrasted.png,1024,1430,245,249
8883,text,341,231,106,21,39_contrasted.png,1024,1430,447,252
8884,text,65,275,64,14,39_contrasted.png,1024,1430,129,289
8885,text,301,275,92,16,39_contrasted.png,1024,1430,393,291
8886,text,571,289,30,18,39_contrasted.png,1024,1430,601,307
8887,text,609,289,124,20,39_contrasted.png,1024,1430,733,309
8888,text,63,345,56,16,39_contrasted.png,1024,1430,119,361
8889,text,133,343,78,18,39_contrasted.png,1024,1430,211,361
8890,text,59,375,264,38,39_contrasted.png,1024,1430,323,413
8891,text,55,445,64,14,39_contrasted.png,1024,1430,119,459
8892,text,173,445,76,16,39_contrasted.png,1024,1430,249,461
8893,text,435,447,24,14,39_contrasted.png,1024,1430,459,461
8894,text,536,447,108,16,39_contrasted.png,1024,1430,644,463
8895,text,715,449,40,14,39_contrasted.png,1024,1430,755,463
8896,text,777,447,52,16,39_contrasted.png,1024,1430,829,463
8897,text,842,446,75,18,39_contrasted.png,1024,1430,917,464
8898,text,51,465,54,20,39_contrasted.png,1024,1430,105,485
8899,text,141,465,148,20,39_contrasted.png,1024,1430,289,485
8900,text,439,469,50,18,39_contrasted.png,1024,1430,489,487
8901,text,532,469,93,20,39_contrasted.png,1024,1430,625,489
8902,text,737,469,34,20,39_contrasted.png,1024,1430,771,489
8903,text,861,469,62,20,39_contrasted.png,1024,1430,923,489
8904,text,47,1067,34,14,39_contrasted.png,1024,1430,81,1081
8905,text,139,1067,32,14,39_contrasted.png,1024,1430,171,1081
8906,text,207,1067,32,14,39_contrasted.png,1024,1430,239,1081
8907,text,293,1067,32,14,39_contrasted.png,1024,1430,325,1081
8908,text,415,1067,54,14,39_contrasted.png,1024,1430,469,1081
8909,text,535,1067,62,16,39_contrasted.png,1024,1430,597,1083
8910,text,686,1066,47,18,39_contrasted.png,1024,1430,733,1084
8911,text,797,1061,104,20,39_contrasted.png,1024,1430,901,1081
8912,text,111,1099,64,20,39_contrasted.png,1024,1430,175,1119
8913,text,207,1101,34,18,39_contrasted.png,1024,1430,241,1119
8914,text,277,1101,50,18,39_contrasted.png,1024,1430,327,1119
8915,text,395,1101,62,18,39_contrasted.png,1024,1430,457,1119
8916,text,545,1101,60,18,39_contrasted.png,1024,1430,605,1119
8917,text,695,1103,40,16,39_contrasted.png,1024,1430,735,1119
8918,text,841,1103,62,16,39_contrasted.png,1024,1430,903,1119
8919,text,357,1136,158,20,39_contrasted.png,1024,1430,515,1156
8920,text,551,1133,78,20,39_contrasted.png,1024,1430,629,1153
8921,text,749,1137,54,18,39_contrasted.png,1024,1430,803,1155
8922,text,855,1135,60,18,39_contrasted.png,1024,1430,915,1153
8923,text,49,1159,38,16,39_contrasted.png,1024,1430,87,1175
8924,text,111,1157,60,18,39_contrasted.png,1024,1430,171,1175
8925,text,277,1157,48,18,39_contrasted.png,1024,1430,325,1175
8926,text,39,1186,294,21,39_contrasted.png,1024,1430,333,1207
8927,text,337,1191,24,14,39_contrasted.png,1024,1430,361,1205
8928,text,359,1187,96,20,39_contrasted.png,1024,1430,455,1207
8929,text,40,1210,488,24,39_contrasted.png,1024,1430,528,1234
8930,text,65,1286,192,17,39_contrasted.png,1024,1430,257,1303
8931,text,64,1303,105,14,39_contrasted.png,1024,1430,169,1317
8932,text,177,1305,168,14,39_contrasted.png,1024,1430,345,1319
8933,text,353,1305,24,14,39_contrasted.png,1024,1430,377,1319
8934,text,383,1305,130,14,39_contrasted.png,1024,1430,513,1319
8935,text,521,1305,118,16,39_contrasted.png,1024,1430,639,1321
8936,text,647,1307,44,14,39_contrasted.png,1024,1430,691,1321
8937,text,695,1307,150,16,39_contrasted.png,1024,1430,845,1323
8938,text,65,1319,184,14,39_contrasted.png,1024,1430,249,1333
8939,text,257,1319,88,16,39_contrasted.png,1024,1430,345,1335
8940,text,353,1319,102,16,39_contrasted.png,1024,1430,455,1335
8941,text,111,1333,68,14,39_contrasted.png,1024,1430,179,1347
8942,text,187,1333,116,16,39_contrasted.png,1024,1430,303,1349
8943,text,309,1335,146,14,39_contrasted.png,1024,1430,455,1349
8944,text,65,1349,128,14,39_contrasted.png,1024,1430,193,1363
8945,text,65,1365,110,14,39_contrasted.png,1024,1430,175,1379
8946,text,839,1193,31,14,39_contrasted.png,1024,1430,870,1207
8947,text,64,1334,45,14,39_contrasted.png,1024,1430,109,1348
8948,text,887,1185,16,21,39_contrasted.png,1024,1430,903,1206
8949,text,42,1099,18,19,39_contrasted.png,1024,1430,60,1118
8950,text,247,63,173,54,39_denoise.png,1024,1430,420,117
8951,text,465,71,345,42,39_denoise.png,1024,1430,810,113
8952,text,277,119,116,14,39_denoise.png,1024,1430,393,133
8953,text,466,108,340,24,39_denoise.png,1024,1430,806,132
8954,text,63,197,98,16,39_denoise.png,1024,1430,161,213
8955,text,213,199,30,14,39_denoise.png,1024,1430,243,213
8956,text,375,201,40,14,39_denoise.png,1024,1430,415,215
8957,text,573,215,84,20,39_denoise.png,1024,1430,657,235
8958,text,59,227,62,20,39_denoise.png,1024,1430,121,247
8959,text,183,229,62,20,39_denoise.png,1024,1430,245,249
8960,text,341,231,106,21,39_denoise.png,1024,1430,447,252
8961,text,65,275,64,14,39_denoise.png,1024,1430,129,289
8962,text,301,275,92,16,39_denoise.png,1024,1430,393,291
8963,text,571,289,30,18,39_denoise.png,1024,1430,601,307
8964,text,609,289,124,20,39_denoise.png,1024,1430,733,309
8965,text,63,345,56,16,39_denoise.png,1024,1430,119,361
8966,text,133,343,78,18,39_denoise.png,1024,1430,211,361
8967,text,59,375,264,38,39_denoise.png,1024,1430,323,413
8968,text,55,445,64,14,39_denoise.png,1024,1430,119,459
8969,text,173,445,76,16,39_denoise.png,1024,1430,249,461
8970,text,435,447,24,14,39_denoise.png,1024,1430,459,461
8971,text,536,447,108,16,39_denoise.png,1024,1430,644,463
8972,text,715,449,40,14,39_denoise.png,1024,1430,755,463
8973,text,777,447,52,16,39_denoise.png,1024,1430,829,463
8974,text,842,446,75,18,39_denoise.png,1024,1430,917,464
8975,text,51,465,54,20,39_denoise.png,1024,1430,105,485
8976,text,141,465,148,20,39_denoise.png,1024,1430,289,485
8977,text,439,469,50,18,39_denoise.png,1024,1430,489,487
8978,text,532,469,93,20,39_denoise.png,1024,1430,625,489
8979,text,737,469,34,20,39_denoise.png,1024,1430,771,489
8980,text,861,469,62,20,39_denoise.png,1024,1430,923,489
8981,text,47,1067,34,14,39_denoise.png,1024,1430,81,1081
8982,text,139,1067,32,14,39_denoise.png,1024,1430,171,1081
8983,text,207,1067,32,14,39_denoise.png,1024,1430,239,1081
8984,text,293,1067,32,14,39_denoise.png,1024,1430,325,1081
8985,text,415,1067,54,14,39_denoise.png,1024,1430,469,1081
8986,text,535,1067,62,16,39_denoise.png,1024,1430,597,1083
8987,text,686,1066,47,18,39_denoise.png,1024,1430,733,1084
8988,text,797,1061,104,20,39_denoise.png,1024,1430,901,1081
8989,text,111,1099,64,20,39_denoise.png,1024,1430,175,1119
8990,text,207,1101,34,18,39_denoise.png,1024,1430,241,1119
8991,text,277,1101,50,18,39_denoise.png,1024,1430,327,1119
8992,text,395,1101,62,18,39_denoise.png,1024,1430,457,1119
8993,text,545,1101,60,18,39_denoise.png,1024,1430,605,1119
8994,text,695,1103,40,16,39_denoise.png,1024,1430,735,1119
8995,text,841,1103,62,16,39_denoise.png,1024,1430,903,1119
8996,text,357,1136,158,20,39_denoise.png,1024,1430,515,1156
8997,text,551,1133,78,20,39_denoise.png,1024,1430,629,1153
8998,text,749,1137,54,18,39_denoise.png,1024,1430,803,1155
8999,text,855,1135,60,18,39_denoise.png,1024,1430,915,1153
9000,text,49,1159,38,16,39_denoise.png,1024,1430,87,1175
9001,text,111,1157,60,18,39_denoise.png,1024,1430,171,1175
9002,text,277,1157,48,18,39_denoise.png,1024,1430,325,1175
9003,text,39,1186,294,21,39_denoise.png,1024,1430,333,1207
9004,text,337,1191,24,14,39_denoise.png,1024,1430,361,1205
9005,text,359,1187,96,20,39_denoise.png,1024,1430,455,1207
9006,text,40,1210,488,24,39_denoise.png,1024,1430,528,1234
9007,text,65,1286,192,17,39_denoise.png,1024,1430,257,1303
9008,text,64,1303,105,14,39_denoise.png,1024,1430,169,1317
9009,text,177,1305,168,14,39_denoise.png,1024,1430,345,1319
9010,text,353,1305,24,14,39_denoise.png,1024,1430,377,1319
9011,text,383,1305,130,14,39_denoise.png,1024,1430,513,1319
9012,text,521,1305,118,16,39_denoise.png,1024,1430,639,1321
9013,text,647,1307,44,14,39_denoise.png,1024,1430,691,1321
9014,text,695,1307,150,16,39_denoise.png,1024,1430,845,1323
9015,text,65,1319,184,14,39_denoise.png,1024,1430,249,1333
9016,text,257,1319,88,16,39_denoise.png,1024,1430,345,1335
9017,text,353,1319,102,16,39_denoise.png,1024,1430,455,1335
9018,text,111,1333,68,14,39_denoise.png,1024,1430,179,1347
9019,text,187,1333,116,16,39_denoise.png,1024,1430,303,1349
9020,text,309,1335,146,14,39_denoise.png,1024,1430,455,1349
9021,text,65,1349,128,14,39_denoise.png,1024,1430,193,1363
9022,text,65,1365,110,14,39_denoise.png,1024,1430,175,1379
9023,text,839,1193,31,14,39_denoise.png,1024,1430,870,1207
9024,text,64,1334,45,14,39_denoise.png,1024,1430,109,1348
9025,text,887,1185,16,21,39_denoise.png,1024,1430,903,1206
9026,text,42,1099,18,19,39_denoise.png,1024,1430,60,1118
9027,text,247,63,173,54,39_median.png,1024,1430,420,117
9028,text,465,71,345,42,39_median.png,1024,1430,810,113
9029,text,277,119,116,14,39_median.png,1024,1430,393,133
9030,text,466,108,340,24,39_median.png,1024,1430,806,132
9031,text,63,197,98,16,39_median.png,1024,1430,161,213
9032,text,213,199,30,14,39_median.png,1024,1430,243,213
9033,text,375,201,40,14,39_median.png,1024,1430,415,215
9034,text,573,215,84,20,39_median.png,1024,1430,657,235
9035,text,59,227,62,20,39_median.png,1024,1430,121,247
9036,text,183,229,62,20,39_median.png,1024,1430,245,249
9037,text,341,231,106,21,39_median.png,1024,1430,447,252
9038,text,65,275,64,14,39_median.png,1024,1430,129,289
9039,text,301,275,92,16,39_median.png,1024,1430,393,291
9040,text,571,289,30,18,39_median.png,1024,1430,601,307
9041,text,609,289,124,20,39_median.png,1024,1430,733,309
9042,text,63,345,56,16,39_median.png,1024,1430,119,361
9043,text,133,343,78,18,39_median.png,1024,1430,211,361
9044,text,59,375,264,38,39_median.png,1024,1430,323,413
9045,text,55,445,64,14,39_median.png,1024,1430,119,459
9046,text,173,445,76,16,39_median.png,1024,1430,249,461
9047,text,435,447,24,14,39_median.png,1024,1430,459,461
9048,text,536,447,108,16,39_median.png,1024,1430,644,463
9049,text,715,449,40,14,39_median.png,1024,1430,755,463
9050,text,777,447,52,16,39_median.png,1024,1430,829,463
9051,text,842,446,75,18,39_median.png,1024,1430,917,464
9052,text,51,465,54,20,39_median.png,1024,1430,105,485
9053,text,141,465,148,20,39_median.png,1024,1430,289,485
9054,text,439,469,50,18,39_median.png,1024,1430,489,487
9055,text,532,469,93,20,39_median.png,1024,1430,625,489
9056,text,737,469,34,20,39_median.png,1024,1430,771,489
9057,text,861,469,62,20,39_median.png,1024,1430,923,489
9058,text,47,1067,34,14,39_median.png,1024,1430,81,1081
9059,text,139,1067,32,14,39_median.png,1024,1430,171,1081
9060,text,207,1067,32,14,39_median.png,1024,1430,239,1081
9061,text,293,1067,32,14,39_median.png,1024,1430,325,1081
9062,text,415,1067,54,14,39_median.png,1024,1430,469,1081
9063,text,535,1067,62,16,39_median.png,1024,1430,597,1083
9064,text,686,1066,47,18,39_median.png,1024,1430,733,1084
9065,text,797,1061,104,20,39_median.png,1024,1430,901,1081
9066,text,111,1099,64,20,39_median.png,1024,1430,175,1119
9067,text,207,1101,34,18,39_median.png,1024,1430,241,1119
9068,text,277,1101,50,18,39_median.png,1024,1430,327,1119
9069,text,395,1101,62,18,39_median.png,1024,1430,457,1119
9070,text,545,1101,60,18,39_median.png,1024,1430,605,1119
9071,text,695,1103,40,16,39_median.png,1024,1430,735,1119
9072,text,841,1103,62,16,39_median.png,1024,1430,903,1119
9073,text,357,1136,158,20,39_median.png,1024,1430,515,1156
9074,text,551,1133,78,20,39_median.png,1024,1430,629,1153
9075,text,749,1137,54,18,39_median.png,1024,1430,803,1155
9076,text,855,1135,60,18,39_median.png,1024,1430,915,1153
9077,text,49,1159,38,16,39_median.png,1024,1430,87,1175
9078,text,111,1157,60,18,39_median.png,1024,1430,171,1175
9079,text,277,1157,48,18,39_median.png,1024,1430,325,1175
9080,text,39,1186,294,21,39_median.png,1024,1430,333,1207
9081,text,337,1191,24,14,39_median.png,1024,1430,361,1205
9082,text,359,1187,96,20,39_median.png,1024,1430,455,1207
9083,text,40,1210,488,24,39_median.png,1024,1430,528,1234
9084,text,65,1286,192,17,39_median.png,1024,1430,257,1303
9085,text,64,1303,105,14,39_median.png,1024,1430,169,1317
9086,text,177,1305,168,14,39_median.png,1024,1430,345,1319
9087,text,353,1305,24,14,39_median.png,1024,1430,377,1319
9088,text,383,1305,130,14,39_median.png,1024,1430,513,1319
9089,text,521,1305,118,16,39_median.png,1024,1430,639,1321
9090,text,647,1307,44,14,39_median.png,1024,1430,691,1321
9091,text,695,1307,150,16,39_median.png,1024,1430,845,1323
9092,text,65,1319,184,14,39_median.png,1024,1430,249,1333
9093,text,257,1319,88,16,39_median.png,1024,1430,345,1335
9094,text,353,1319,102,16,39_median.png,1024,1430,455,1335
9095,text,111,1333,68,14,39_median.png,1024,1430,179,1347
9096,text,187,1333,116,16,39_median.png,1024,1430,303,1349
9097,text,309,1335,146,14,39_median.png,1024,1430,455,1349
9098,text,65,1349,128,14,39_median.png,1024,1430,193,1363
9099,text,65,1365,110,14,39_median.png,1024,1430,175,1379
9100,text,839,1193,31,14,39_median.png,1024,1430,870,1207
9101,text,64,1334,45,14,39_median.png,1024,1430,109,1348
9102,text,887,1185,16,21,39_median.png,1024,1430,903,1206
9103,text,42,1099,18,19,39_median.png,1024,1430,60,1118
9104,text,129,70,191,57,3_contrasted.png,1024,1448,320,127
9105,text,642,98,254,32,3_contrasted.png,1024,1448,896,130
9106,text,737,179,44,20,3_contrasted.png,1024,1448,781,199
9107,text,716,201,86,24,3_contrasted.png,1024,1448,802,225
9108,text,709,225,100,18,3_contrasted.png,1024,1448,809,243
9109,text,683,247,150,18,3_contrasted.png,1024,1448,833,265
9110,text,711,269,44,16,3_contrasted.png,1024,1448,755,285
9111,text,765,271,38,14,3_contrasted.png,1024,1448,803,285
9112,text,133,305,72,18,3_contrasted.png,1024,1448,205,323
9113,text,233,305,134,20,3_contrasted.png,1024,1448,367,325
9114,text,135,329,34,16,3_contrasted.png,1024,1448,169,345
9115,text,235,329,206,20,3_contrasted.png,1024,1448,441,349
9116,text,135,351,70,16,3_contrasted.png,1024,1448,205,367
9117,text,233,348,126,20,3_contrasted.png,1024,1448,359,368
9118,text,133,373,56,16,3_contrasted.png,1024,1448,189,389
9119,text,233,371,74,20,3_contrasted.png,1024,1448,307,391
9120,text,245,483,82,18,3_contrasted.png,1024,1448,327,501
9121,text,463,483,38,20,3_contrasted.png,1024,1448,501,503
9122,text,533,485,62,16,3_contrasted.png,1024,1448,595,501
9123,text,643,483,62,20,3_contrasted.png,1024,1448,705,503
9124,text,787,485,74,20,3_contrasted.png,1024,1448,861,505
9125,text,156,523,259,20,3_contrasted.png,1024,1448,415,543
9126,text,461,525,43,24,3_contrasted.png,1024,1448,504,549
9127,text,539,525,42,16,3_contrasted.png,1024,1448,581,541
9128,text,677,527,68,16,3_contrasted.png,1024,1448,745,543
9129,text,829,527,72,18,3_contrasted.png,1024,1448,901,545
9130,text,613,765,112,20,3_contrasted.png,1024,1448,725,785
9131,text,827,769,70,16,3_contrasted.png,1024,1448,897,785
9132,text,613,787,110,20,3_contrasted.png,1024,1448,723,807
9133,text,825,789,72,20,3_contrasted.png,1024,1448,897,809
9134,text,607,805,121,25,3_contrasted.png,1024,1448,728,830
9135,text,827,811,70,18,3_contrasted.png,1024,1448,897,829
9136,text,123,871,284,20,3_contrasted.png,1024,1448,407,891
9137,text,255,895,340,18,3_contrasted.png,1024,1448,595,913
9138,text,199,976,151,27,3_contrasted.png,1024,1448,350,1003
9139,text,193,1003,228,18,3_contrasted.png,1024,1448,421,1021
9140,text,173,1027,126,16,3_contrasted.png,1024,1448,299,1043
9141,text,449,1294,104,13,3_contrasted.png,1024,1448,553,1307
9142,text,315,1307,295,14,3_contrasted.png,1024,1448,610,1321
9143,text,613,1309,74,14,3_contrasted.png,1024,1448,687,1323
9144,text,369,1319,22,14,3_contrasted.png,1024,1448,391,1333
9145,text,395,1319,100,14,3_contrasted.png,1024,1448,495,1333
9146,text,523,1321,34,12,3_contrasted.png,1024,1448,557,1333
9147,text,563,1321,68,14,3_contrasted.png,1024,1448,631,1335
9148,text,204,1090,137,19,3_contrasted.png,1024,1448,341,1109
9149,text,114,1221,181,17,3_contrasted.png,1024,1448,295,1238
9150,text,499,1321,19,12,3_contrasted.png,1024,1448,518,1333
9151,text,129,70,191,57,3_denoise.png,1024,1448,320,127
9152,text,642,98,254,32,3_denoise.png,1024,1448,896,130
9153,text,737,179,44,20,3_denoise.png,1024,1448,781,199
9154,text,716,201,86,24,3_denoise.png,1024,1448,802,225
9155,text,709,225,100,18,3_denoise.png,1024,1448,809,243
9156,text,683,247,150,18,3_denoise.png,1024,1448,833,265
9157,text,711,269,44,16,3_denoise.png,1024,1448,755,285
9158,text,765,271,38,14,3_denoise.png,1024,1448,803,285
9159,text,133,305,72,18,3_denoise.png,1024,1448,205,323
9160,text,233,305,134,20,3_denoise.png,1024,1448,367,325
9161,text,135,329,34,16,3_denoise.png,1024,1448,169,345
9162,text,235,329,206,20,3_denoise.png,1024,1448,441,349
9163,text,135,351,70,16,3_denoise.png,1024,1448,205,367
9164,text,233,348,126,20,3_denoise.png,1024,1448,359,368
9165,text,133,373,56,16,3_denoise.png,1024,1448,189,389
9166,text,233,371,74,20,3_denoise.png,1024,1448,307,391
9167,text,245,483,82,18,3_denoise.png,1024,1448,327,501
9168,text,463,483,38,20,3_denoise.png,1024,1448,501,503
9169,text,533,485,62,16,3_denoise.png,1024,1448,595,501
9170,text,643,483,62,20,3_denoise.png,1024,1448,705,503
9171,text,787,485,74,20,3_denoise.png,1024,1448,861,505
9172,text,156,523,259,20,3_denoise.png,1024,1448,415,543
9173,text,461,525,43,24,3_denoise.png,1024,1448,504,549
9174,text,539,525,42,16,3_denoise.png,1024,1448,581,541
9175,text,677,527,68,16,3_denoise.png,1024,1448,745,543
9176,text,829,527,72,18,3_denoise.png,1024,1448,901,545
9177,text,613,765,112,20,3_denoise.png,1024,1448,725,785
9178,text,827,769,70,16,3_denoise.png,1024,1448,897,785
9179,text,613,787,110,20,3_denoise.png,1024,1448,723,807
9180,text,825,789,72,20,3_denoise.png,1024,1448,897,809
9181,text,607,805,121,25,3_denoise.png,1024,1448,728,830
9182,text,827,811,70,18,3_denoise.png,1024,1448,897,829
9183,text,123,871,284,20,3_denoise.png,1024,1448,407,891
9184,text,255,895,340,18,3_denoise.png,1024,1448,595,913
9185,text,199,976,151,27,3_denoise.png,1024,1448,350,1003
9186,text,193,1003,228,18,3_denoise.png,1024,1448,421,1021
9187,text,173,1027,126,16,3_denoise.png,1024,1448,299,1043
9188,text,449,1294,104,13,3_denoise.png,1024,1448,553,1307
9189,text,315,1307,295,14,3_denoise.png,1024,1448,610,1321
9190,text,613,1309,74,14,3_denoise.png,1024,1448,687,1323
9191,text,369,1319,22,14,3_denoise.png,1024,1448,391,1333
9192,text,395,1319,100,14,3_denoise.png,1024,1448,495,1333
9193,text,523,1321,34,12,3_denoise.png,1024,1448,557,1333
9194,text,563,1321,68,14,3_denoise.png,1024,1448,631,1335
9195,text,204,1090,137,19,3_denoise.png,1024,1448,341,1109
9196,text,114,1221,181,17,3_denoise.png,1024,1448,295,1238
9197,text,499,1321,19,12,3_denoise.png,1024,1448,518,1333
9198,text,129,70,191,57,3_median.png,1024,1448,320,127
9199,text,642,98,254,32,3_median.png,1024,1448,896,130
9200,text,737,179,44,20,3_median.png,1024,1448,781,199
9201,text,716,201,86,24,3_median.png,1024,1448,802,225
9202,text,709,225,100,18,3_median.png,1024,1448,809,243
9203,text,683,247,150,18,3_median.png,1024,1448,833,265
9204,text,711,269,44,16,3_median.png,1024,1448,755,285
9205,text,765,271,38,14,3_median.png,1024,1448,803,285
9206,text,133,305,72,18,3_median.png,1024,1448,205,323
9207,text,233,305,134,20,3_median.png,1024,1448,367,325
9208,text,135,329,34,16,3_median.png,1024,1448,169,345
9209,text,235,329,206,20,3_median.png,1024,1448,441,349
9210,text,135,351,70,16,3_median.png,1024,1448,205,367
9211,text,233,348,126,20,3_median.png,1024,1448,359,368
9212,text,133,373,56,16,3_median.png,1024,1448,189,389
9213,text,233,371,74,20,3_median.png,1024,1448,307,391
9214,text,245,483,82,18,3_median.png,1024,1448,327,501
9215,text,463,483,38,20,3_median.png,1024,1448,501,503
9216,text,533,485,62,16,3_median.png,1024,1448,595,501
9217,text,643,483,62,20,3_median.png,1024,1448,705,503
9218,text,787,485,74,20,3_median.png,1024,1448,861,505
9219,text,156,523,259,20,3_median.png,1024,1448,415,543
9220,text,461,525,43,24,3_median.png,1024,1448,504,549
9221,text,539,525,42,16,3_median.png,1024,1448,581,541
9222,text,677,527,68,16,3_median.png,1024,1448,745,543
9223,text,829,527,72,18,3_median.png,1024,1448,901,545
9224,text,613,765,112,20,3_median.png,1024,1448,725,785
9225,text,827,769,70,16,3_median.png,1024,1448,897,785
9226,text,613,787,110,20,3_median.png,1024,1448,723,807
9227,text,825,789,72,20,3_median.png,1024,1448,897,809
9228,text,607,805,121,25,3_median.png,1024,1448,728,830
9229,text,827,811,70,18,3_median.png,1024,1448,897,829
9230,text,123,871,284,20,3_median.png,1024,1448,407,891
9231,text,255,895,340,18,3_median.png,1024,1448,595,913
9232,text,199,976,151,27,3_median.png,1024,1448,350,1003
9233,text,193,1003,228,18,3_median.png,1024,1448,421,1021
9234,text,173,1027,126,16,3_median.png,1024,1448,299,1043
9235,text,449,1294,104,13,3_median.png,1024,1448,553,1307
9236,text,315,1307,295,14,3_median.png,1024,1448,610,1321
9237,text,613,1309,74,14,3_median.png,1024,1448,687,1323
9238,text,369,1319,22,14,3_median.png,1024,1448,391,1333
9239,text,395,1319,100,14,3_median.png,1024,1448,495,1333
9240,text,523,1321,34,12,3_median.png,1024,1448,557,1333
9241,text,563,1321,68,14,3_median.png,1024,1448,631,1335
9242,text,204,1090,137,19,3_median.png,1024,1448,341,1109
9243,text,114,1221,181,17,3_median.png,1024,1448,295,1238
9244,text,499,1321,19,12,3_median.png,1024,1448,518,1333
9245,text,363,93,162,40,4.png,1024,1430,525,133
9246,text,198,139,520,27,4.png,1024,1430,718,166
9247,text,627,241,132,20,4.png,1024,1430,759,261
9248,text,629,259,246,20,4.png,1024,1430,875,279
9249,text,625,279,162,20,4.png,1024,1430,787,299
9250,text,631,297,106,20,4.png,1024,1430,737,317
9251,text,375,393,152,42,4.png,1024,1430,527,435
9252,text,41,469,38,16,4.png,1024,1430,79,485
9253,text,69,517,106,20,4.png,1024,1430,175,537
9254,text,183,517,70,20,4.png,1024,1430,253,537
9255,text,311,515,50,20,4.png,1024,1430,361,535
9256,text,387,515,68,20,4.png,1024,1430,455,535
9257,text,523,513,48,20,4.png,1024,1430,571,533
9258,text,709,511,118,20,4.png,1024,1430,827,531
9259,text,849,509,68,20,4.png,1024,1430,917,529
9260,text,61,577,74,16,4.png,1024,1430,135,593
9261,text,299,575,88,18,4.png,1024,1430,387,593
9262,text,571,569,30,18,4.png,1024,1430,601,587
9263,text,639,571,78,16,4.png,1024,1430,717,587
9264,text,737,571,56,18,4.png,1024,1430,793,589
9265,text,825,571,84,16,4.png,1024,1430,909,587
9266,text,41,607,94,18,4.png,1024,1430,135,625
9267,text,165,607,188,16,4.png,1024,1430,353,623
9268,text,671,603,58,17,4.png,1024,1430,729,620
9269,text,871,605,46,16,4.png,1024,1430,917,621
9270,text,43,625,93,15,4.png,1024,1430,136,640
9271,text,207,623,177,15,4.png,1024,1430,384,638
9272,text,671,620,58,15,4.png,1024,1430,729,635
9273,text,871,619,47,16,4.png,1024,1430,918,635
9274,text,43,639,92,16,4.png,1024,1430,135,655
9275,text,165,638,196,13,4.png,1024,1430,361,651
9276,text,673,635,55,16,4.png,1024,1430,728,651
9277,text,42,655,95,16,4.png,1024,1430,137,671
9278,text,165,651,184,17,4.png,1024,1430,349,668
9279,text,673,651,56,16,4.png,1024,1430,729,667
9280,text,41,670,96,15,4.png,1024,1430,137,685
9281,text,164,668,224,16,4.png,1024,1430,388,684
9282,text,871,665,47,16,4.png,1024,1430,918,681
9283,text,43,685,94,15,4.png,1024,1430,137,700
9284,text,165,684,189,15,4.png,1024,1430,354,699
9285,text,673,681,56,16,4.png,1024,1430,729,697
9286,text,871,681,47,14,4.png,1024,1430,918,695
9287,text,41,701,72,16,4.png,1024,1430,113,717
9288,text,162,698,372,16,4.png,1024,1430,534,714
9289,text,671,696,58,17,4.png,1024,1430,729,713
9290,text,869,693,50,18,4.png,1024,1430,919,711
9291,text,135,1055,154,20,4.png,1024,1430,289,1075
9292,text,731,1063,70,20,4.png,1024,1430,801,1083
9293,text,859,1063,68,20,4.png,1024,1430,927,1083
9294,text,187,1083,38,18,4.png,1024,1430,225,1101
9295,text,731,1093,90,20,4.png,1024,1430,821,1113
9296,text,871,1093,56,20,4.png,1024,1430,927,1113
9297,text,162,1106,86,18,4.png,1024,1430,248,1124
9298,text,730,1122,82,24,4.png,1024,1430,812,1146
9299,text,860,1122,68,24,4.png,1024,1430,928,1146
9300,text,183,1139,28,16,4.png,1024,1430,211,1155
9301,text,269,1137,32,18,4.png,1024,1430,301,1155
9302,text,36,1168,378,24,4.png,1024,1430,414,1192
9303,text,35,1195,162,16,4.png,1024,1430,197,1211
9304,text,195,1191,151,21,4.png,1024,1430,346,1212
9305,text,348,1223,276,18,4.png,1024,1430,624,1241
9306,text,135,1241,138,20,4.png,1024,1430,273,1261
9307,text,283,1243,86,18,4.png,1024,1430,369,1261
9308,text,383,1241,26,18,4.png,1024,1430,409,1259
9309,text,419,1239,274,20,4.png,1024,1430,693,1259
9310,text,701,1241,28,16,4.png,1024,1430,729,1257
9311,text,737,1239,90,18,4.png,1024,1430,827,1257
9312,text,169,1261,24,20,4.png,1024,1430,193,1281
9313,text,199,1260,82,19,4.png,1024,1430,281,1279
9314,text,305,1259,82,18,4.png,1024,1430,387,1277
9315,text,407,1257,126,20,4.png,1024,1430,533,1277
9316,text,552,1254,144,24,4.png,1024,1430,696,1278
9317,text,164,624,44,16,4.png,1024,1430,208,640
9318,text,586,606,14,14,4.png,1024,1430,600,620
9319,text,586,620,14,16,4.png,1024,1430,600,636
9320,text,585,635,14,17,4.png,1024,1430,599,652
9321,text,586,651,14,15,4.png,1024,1430,600,666
9322,text,586,667,14,14,4.png,1024,1430,600,681
9323,text,586,681,14,15,4.png,1024,1430,600,696
9324,text,586,697,13,17,4.png,1024,1430,599,714
9325,text,672,667,58,13,4.png,1024,1430,730,680
9326,text,870,634,50,15,4.png,1024,1430,920,649
9327,text,870,649,48,16,4.png,1024,1430,918,665
9328,text,705,1257,159,18,4.png,1024,1430,864,1275
9329,text,889,12,109,30,40.png,1024,1448,998,42
9330,text,145,77,622,110,40.png,1024,1448,767,187
9331,text,783,135,140,44,40.png,1024,1448,923,179
9332,text,370,262,200,24,40.png,1024,1448,570,286
9333,text,119,367,140,40,40.png,1024,1448,259,407
9334,text,271,363,528,42,40.png,1024,1448,799,405
9335,text,368,414,198,24,40.png,1024,1448,566,438
9336,text,354,440,228,26,40.png,1024,1448,582,466
9337,text,196,494,104,26,40.png,1024,1448,300,520
9338,text,561,495,34,20,40.png,1024,1448,595,515
9339,text,646,492,82,24,40.png,1024,1448,728,516
9340,text,750,490,94,24,40.png,1024,1448,844,514
9341,text,132,598,220,24,40.png,1024,1448,352,622
9342,text,650,596,74,24,40.png,1024,1448,724,620
9343,text,760,596,74,24,40.png,1024,1448,834,620
9344,text,356,728,112,24,40.png,1024,1448,468,752
9345,text,758,728,74,24,40.png,1024,1448,832,752
9346,text,364,754,94,24,40.png,1024,1448,458,778
9347,text,764,754,62,24,40.png,1024,1448,826,778
9348,text,350,780,124,24,40.png,1024,1448,474,804
9349,text,758,778,74,26,40.png,1024,1448,832,804
9350,text,82,858,436,24,40.png,1024,1448,518,882
9351,text,81,885,212,20,40.png,1024,1448,293,905
9352,text,307,885,40,20,40.png,1024,1448,347,905
9353,text,220,1368,134,24,40.png,1024,1448,354,1392
9354,text,365,1369,272,20,40.png,1024,1448,637,1389
9355,text,651,1369,128,20,40.png,1024,1448,779,1389
9356,text,131,1386,47,26,40.png,1024,1448,178,1412
9357,text,189,1389,82,20,40.png,1024,1448,271,1409
9358,text,285,1389,152,20,40.png,1024,1448,437,1409
9359,text,449,1389,144,20,40.png,1024,1448,593,1409
9360,text,607,1389,42,20,40.png,1024,1448,649,1409
9361,text,660,1386,210,24,40.png,1024,1448,870,1410
9362,text,459,599,18,23,40.png,1024,1448,477,622
9363,text,456,493,23,20,40.png,1024,1448,479,513
9364,text,569,597,18,25,40.png,1024,1448,587,622
9365,text,889,12,109,30,40_contrasted.png,1024,1448,998,42
9366,text,145,77,622,110,40_contrasted.png,1024,1448,767,187
9367,text,783,135,140,44,40_contrasted.png,1024,1448,923,179
9368,text,370,262,200,24,40_contrasted.png,1024,1448,570,286
9369,text,119,367,140,40,40_contrasted.png,1024,1448,259,407
9370,text,271,363,528,42,40_contrasted.png,1024,1448,799,405
9371,text,368,414,198,24,40_contrasted.png,1024,1448,566,438
9372,text,354,440,228,26,40_contrasted.png,1024,1448,582,466
9373,text,196,494,104,26,40_contrasted.png,1024,1448,300,520
9374,text,561,495,34,20,40_contrasted.png,1024,1448,595,515
9375,text,646,492,82,24,40_contrasted.png,1024,1448,728,516
9376,text,750,490,94,24,40_contrasted.png,1024,1448,844,514
9377,text,132,598,220,24,40_contrasted.png,1024,1448,352,622
9378,text,650,596,74,24,40_contrasted.png,1024,1448,724,620
9379,text,760,596,74,24,40_contrasted.png,1024,1448,834,620
9380,text,356,728,112,24,40_contrasted.png,1024,1448,468,752
9381,text,758,728,74,24,40_contrasted.png,1024,1448,832,752
9382,text,364,754,94,24,40_contrasted.png,1024,1448,458,778
9383,text,764,754,62,24,40_contrasted.png,1024,1448,826,778
9384,text,350,780,124,24,40_contrasted.png,1024,1448,474,804
9385,text,758,778,74,26,40_contrasted.png,1024,1448,832,804
9386,text,82,858,436,24,40_contrasted.png,1024,1448,518,882
9387,text,81,885,212,20,40_contrasted.png,1024,1448,293,905
9388,text,307,885,40,20,40_contrasted.png,1024,1448,347,905
9389,text,220,1368,134,24,40_contrasted.png,1024,1448,354,1392
9390,text,365,1369,272,20,40_contrasted.png,1024,1448,637,1389
9391,text,651,1369,128,20,40_contrasted.png,1024,1448,779,1389
9392,text,131,1386,47,26,40_contrasted.png,1024,1448,178,1412
9393,text,189,1389,82,20,40_contrasted.png,1024,1448,271,1409
9394,text,285,1389,152,20,40_contrasted.png,1024,1448,437,1409
9395,text,449,1389,144,20,40_contrasted.png,1024,1448,593,1409
9396,text,607,1389,42,20,40_contrasted.png,1024,1448,649,1409
9397,text,660,1386,210,24,40_contrasted.png,1024,1448,870,1410
9398,text,459,599,18,23,40_contrasted.png,1024,1448,477,622
9399,text,456,493,23,20,40_contrasted.png,1024,1448,479,513
9400,text,569,597,18,25,40_contrasted.png,1024,1448,587,622
9401,text,889,12,109,30,40_denoise.png,1024,1448,998,42
9402,text,145,77,622,110,40_denoise.png,1024,1448,767,187
9403,text,783,135,140,44,40_denoise.png,1024,1448,923,179
9404,text,370,262,200,24,40_denoise.png,1024,1448,570,286
9405,text,119,367,140,40,40_denoise.png,1024,1448,259,407
9406,text,271,363,528,42,40_denoise.png,1024,1448,799,405
9407,text,368,414,198,24,40_denoise.png,1024,1448,566,438
9408,text,354,440,228,26,40_denoise.png,1024,1448,582,466
9409,text,196,494,104,26,40_denoise.png,1024,1448,300,520
9410,text,561,495,34,20,40_denoise.png,1024,1448,595,515
9411,text,646,492,82,24,40_denoise.png,1024,1448,728,516
9412,text,750,490,94,24,40_denoise.png,1024,1448,844,514
9413,text,132,598,220,24,40_denoise.png,1024,1448,352,622
9414,text,650,596,74,24,40_denoise.png,1024,1448,724,620
9415,text,760,596,74,24,40_denoise.png,1024,1448,834,620
9416,text,356,728,112,24,40_denoise.png,1024,1448,468,752
9417,text,758,728,74,24,40_denoise.png,1024,1448,832,752
9418,text,364,754,94,24,40_denoise.png,1024,1448,458,778
9419,text,764,754,62,24,40_denoise.png,1024,1448,826,778
9420,text,350,780,124,24,40_denoise.png,1024,1448,474,804
9421,text,758,778,74,26,40_denoise.png,1024,1448,832,804
9422,text,82,858,436,24,40_denoise.png,1024,1448,518,882
9423,text,81,885,212,20,40_denoise.png,1024,1448,293,905
9424,text,307,885,40,20,40_denoise.png,1024,1448,347,905
9425,text,220,1368,134,24,40_denoise.png,1024,1448,354,1392
9426,text,365,1369,272,20,40_denoise.png,1024,1448,637,1389
9427,text,651,1369,128,20,40_denoise.png,1024,1448,779,1389
9428,text,131,1386,47,26,40_denoise.png,1024,1448,178,1412
9429,text,189,1389,82,20,40_denoise.png,1024,1448,271,1409
9430,text,285,1389,152,20,40_denoise.png,1024,1448,437,1409
9431,text,449,1389,144,20,40_denoise.png,1024,1448,593,1409
9432,text,607,1389,42,20,40_denoise.png,1024,1448,649,1409
9433,text,660,1386,210,24,40_denoise.png,1024,1448,870,1410
9434,text,459,599,18,23,40_denoise.png,1024,1448,477,622
9435,text,456,493,23,20,40_denoise.png,1024,1448,479,513
9436,text,569,597,18,25,40_denoise.png,1024,1448,587,622
9437,text,889,12,109,30,40_median.png,1024,1448,998,42
9438,text,145,77,622,110,40_median.png,1024,1448,767,187
9439,text,783,135,140,44,40_median.png,1024,1448,923,179
9440,text,370,262,200,24,40_median.png,1024,1448,570,286
9441,text,119,367,140,40,40_median.png,1024,1448,259,407
9442,text,271,363,528,42,40_median.png,1024,1448,799,405
9443,text,368,414,198,24,40_median.png,1024,1448,566,438
9444,text,354,440,228,26,40_median.png,1024,1448,582,466
9445,text,196,494,104,26,40_median.png,1024,1448,300,520
9446,text,561,495,34,20,40_median.png,1024,1448,595,515
9447,text,646,492,82,24,40_median.png,1024,1448,728,516
9448,text,750,490,94,24,40_median.png,1024,1448,844,514
9449,text,132,598,220,24,40_median.png,1024,1448,352,622
9450,text,650,596,74,24,40_median.png,1024,1448,724,620
9451,text,760,596,74,24,40_median.png,1024,1448,834,620
9452,text,356,728,112,24,40_median.png,1024,1448,468,752
9453,text,758,728,74,24,40_median.png,1024,1448,832,752
9454,text,364,754,94,24,40_median.png,1024,1448,458,778
9455,text,764,754,62,24,40_median.png,1024,1448,826,778
9456,text,350,780,124,24,40_median.png,1024,1448,474,804
9457,text,758,778,74,26,40_median.png,1024,1448,832,804
9458,text,82,858,436,24,40_median.png,1024,1448,518,882
9459,text,81,885,212,20,40_median.png,1024,1448,293,905
9460,text,307,885,40,20,40_median.png,1024,1448,347,905
9461,text,220,1368,134,24,40_median.png,1024,1448,354,1392
9462,text,365,1369,272,20,40_median.png,1024,1448,637,1389
9463,text,651,1369,128,20,40_median.png,1024,1448,779,1389
9464,text,131,1386,47,26,40_median.png,1024,1448,178,1412
9465,text,189,1389,82,20,40_median.png,1024,1448,271,1409
9466,text,285,1389,152,20,40_median.png,1024,1448,437,1409
9467,text,449,1389,144,20,40_median.png,1024,1448,593,1409
9468,text,607,1389,42,20,40_median.png,1024,1448,649,1409
9469,text,660,1386,210,24,40_median.png,1024,1448,870,1410
9470,text,459,599,18,23,40_median.png,1024,1448,477,622
9471,text,456,493,23,20,40_median.png,1024,1448,479,513
9472,text,569,597,18,25,40_median.png,1024,1448,587,622
9473,text,624,62,320,54,41.png,1024,1448,944,116
9474,text,539,241,155,24,41.png,1024,1448,694,265
9475,text,541,263,110,20,41.png,1024,1448,651,283
9476,text,538,304,116,20,41.png,1024,1448,654,324
9477,text,541,325,194,20,41.png,1024,1448,735,345
9478,text,743,327,28,18,41.png,1024,1448,771,345
9479,text,54,384,200,24,41.png,1024,1448,254,408
9480,text,51,405,77,26,41.png,1024,1448,128,431
9481,text,99,459,82,20,41.png,1024,1448,181,479
9482,text,279,461,60,18,41.png,1024,1448,339,479
9483,text,431,461,72,20,41.png,1024,1448,503,481
9484,text,656,462,156,24,41.png,1024,1448,812,486
9485,text,93,489,96,20,41.png,1024,1448,189,509
9486,text,263,489,94,20,41.png,1024,1448,357,509
9487,text,423,491,88,20,41.png,1024,1448,511,511
9488,text,89,557,84,20,41.png,1024,1448,173,577
9489,text,286,558,98,20,41.png,1024,1448,384,578
9490,text,495,559,38,20,41.png,1024,1448,533,579
9491,text,571,559,54,20,41.png,1024,1448,625,579
9492,text,655,561,30,20,41.png,1024,1448,685,581
9493,text,785,565,68,16,41.png,1024,1448,853,581
9494,text,90,580,80,24,41.png,1024,1448,170,604
9495,text,255,583,162,20,41.png,1024,1448,417,603
9496,text,571,585,54,20,41.png,1024,1448,625,605
9497,text,659,587,24,18,41.png,1024,1448,683,605
9498,text,793,587,46,20,41.png,1024,1448,839,607
9499,text,91,607,76,20,41.png,1024,1448,167,627
9500,text,270,606,130,24,41.png,1024,1448,400,630
9501,text,575,609,46,20,41.png,1024,1448,621,629
9502,text,659,611,24,20,41.png,1024,1448,683,631
9503,text,795,613,44,18,41.png,1024,1448,839,631
9504,text,91,631,78,20,41.png,1024,1448,169,651
9505,text,247,633,176,20,41.png,1024,1448,423,653
9506,text,569,635,56,20,41.png,1024,1448,625,655
9507,text,659,635,22,20,41.png,1024,1448,681,655
9508,text,789,637,54,18,41.png,1024,1448,843,655
9509,text,107,1167,70,18,41.png,1024,1448,177,1185
9510,text,285,1167,50,20,41.png,1024,1448,335,1187
9511,text,465,1169,78,18,41.png,1024,1448,543,1187
9512,text,731,1169,78,20,41.png,1024,1448,809,1189
9513,text,113,1195,54,20,41.png,1024,1448,167,1215
9514,text,287,1197,46,20,41.png,1024,1448,333,1217
9515,text,481,1199,46,20,41.png,1024,1448,527,1219
9516,text,741,1199,54,20,41.png,1024,1448,795,1219
9517,text,54,1238,416,24,41.png,1024,1448,470,1262
9518,text,54,1258,446,24,41.png,1024,1448,500,1282
9519,text,407,1359,214,16,41.png,1024,1448,621,1375
9520,text,293,1377,144,16,41.png,1024,1448,437,1393
9521,text,447,1377,94,16,41.png,1024,1448,541,1393
9522,text,549,1377,38,14,41.png,1024,1448,587,1391
9523,text,595,1377,140,16,41.png,1024,1448,735,1393
9524,text,253,1397,70,14,41.png,1024,1448,323,1411
9525,text,351,1397,54,14,41.png,1024,1448,405,1411
9526,text,413,1397,46,14,41.png,1024,1448,459,1411
9527,text,465,1395,60,16,41.png,1024,1448,525,1411
9528,text,533,1395,34,16,41.png,1024,1448,567,1411
9529,text,573,1395,54,16,41.png,1024,1448,627,1411
9530,text,633,1395,24,16,41.png,1024,1448,657,1411
9531,text,663,1395,110,16,41.png,1024,1448,773,1411
9532,text,506,585,16,19,41.png,1024,1448,522,604
9533,text,506,610,15,18,41.png,1024,1448,521,628
9534,text,506,634,15,17,41.png,1024,1448,521,651
9535,text,332,1396,12,16,41.png,1024,1448,344,1412
9536,text,624,62,320,54,41_contrasted.png,1024,1448,944,116
9537,text,539,241,155,24,41_contrasted.png,1024,1448,694,265
9538,text,541,263,110,20,41_contrasted.png,1024,1448,651,283
9539,text,538,304,116,20,41_contrasted.png,1024,1448,654,324
9540,text,541,325,194,20,41_contrasted.png,1024,1448,735,345
9541,text,743,327,28,18,41_contrasted.png,1024,1448,771,345
9542,text,54,384,200,24,41_contrasted.png,1024,1448,254,408
9543,text,51,405,77,26,41_contrasted.png,1024,1448,128,431
9544,text,99,459,82,20,41_contrasted.png,1024,1448,181,479
9545,text,279,461,60,18,41_contrasted.png,1024,1448,339,479
9546,text,431,461,72,20,41_contrasted.png,1024,1448,503,481
9547,text,656,462,156,24,41_contrasted.png,1024,1448,812,486
9548,text,93,489,96,20,41_contrasted.png,1024,1448,189,509
9549,text,263,489,94,20,41_contrasted.png,1024,1448,357,509
9550,text,423,491,88,20,41_contrasted.png,1024,1448,511,511
9551,text,89,557,84,20,41_contrasted.png,1024,1448,173,577
9552,text,286,558,98,20,41_contrasted.png,1024,1448,384,578
9553,text,495,559,38,20,41_contrasted.png,1024,1448,533,579
9554,text,571,559,54,20,41_contrasted.png,1024,1448,625,579
9555,text,655,561,30,20,41_contrasted.png,1024,1448,685,581
9556,text,785,565,68,16,41_contrasted.png,1024,1448,853,581
9557,text,90,580,80,24,41_contrasted.png,1024,1448,170,604
9558,text,255,583,162,20,41_contrasted.png,1024,1448,417,603
9559,text,571,585,54,20,41_contrasted.png,1024,1448,625,605
9560,text,659,587,24,18,41_contrasted.png,1024,1448,683,605
9561,text,793,587,46,20,41_contrasted.png,1024,1448,839,607
9562,text,91,607,76,20,41_contrasted.png,1024,1448,167,627
9563,text,270,606,130,24,41_contrasted.png,1024,1448,400,630
9564,text,575,609,46,20,41_contrasted.png,1024,1448,621,629
9565,text,659,611,24,20,41_contrasted.png,1024,1448,683,631
9566,text,795,613,44,18,41_contrasted.png,1024,1448,839,631
9567,text,91,631,78,20,41_contrasted.png,1024,1448,169,651
9568,text,247,633,176,20,41_contrasted.png,1024,1448,423,653
9569,text,569,635,56,20,41_contrasted.png,1024,1448,625,655
9570,text,659,635,22,20,41_contrasted.png,1024,1448,681,655
9571,text,789,637,54,18,41_contrasted.png,1024,1448,843,655
9572,text,107,1167,70,18,41_contrasted.png,1024,1448,177,1185
9573,text,285,1167,50,20,41_contrasted.png,1024,1448,335,1187
9574,text,465,1169,78,18,41_contrasted.png,1024,1448,543,1187
9575,text,731,1169,78,20,41_contrasted.png,1024,1448,809,1189
9576,text,113,1195,54,20,41_contrasted.png,1024,1448,167,1215
9577,text,287,1197,46,20,41_contrasted.png,1024,1448,333,1217
9578,text,481,1199,46,20,41_contrasted.png,1024,1448,527,1219
9579,text,741,1199,54,20,41_contrasted.png,1024,1448,795,1219
9580,text,54,1238,416,24,41_contrasted.png,1024,1448,470,1262
9581,text,54,1258,446,24,41_contrasted.png,1024,1448,500,1282
9582,text,407,1359,214,16,41_contrasted.png,1024,1448,621,1375
9583,text,293,1377,144,16,41_contrasted.png,1024,1448,437,1393
9584,text,447,1377,94,16,41_contrasted.png,1024,1448,541,1393
9585,text,549,1377,38,14,41_contrasted.png,1024,1448,587,1391
9586,text,595,1377,140,16,41_contrasted.png,1024,1448,735,1393
9587,text,253,1397,70,14,41_contrasted.png,1024,1448,323,1411
9588,text,351,1397,54,14,41_contrasted.png,1024,1448,405,1411
9589,text,413,1397,46,14,41_contrasted.png,1024,1448,459,1411
9590,text,465,1395,60,16,41_contrasted.png,1024,1448,525,1411
9591,text,533,1395,34,16,41_contrasted.png,1024,1448,567,1411
9592,text,573,1395,54,16,41_contrasted.png,1024,1448,627,1411
9593,text,633,1395,24,16,41_contrasted.png,1024,1448,657,1411
9594,text,663,1395,110,16,41_contrasted.png,1024,1448,773,1411
9595,text,506,585,16,19,41_contrasted.png,1024,1448,522,604
9596,text,506,610,15,18,41_contrasted.png,1024,1448,521,628
9597,text,506,634,15,17,41_contrasted.png,1024,1448,521,651
9598,text,332,1396,12,16,41_contrasted.png,1024,1448,344,1412
9599,text,624,62,320,54,41_denoise.png,1024,1448,944,116
9600,text,539,241,155,24,41_denoise.png,1024,1448,694,265
9601,text,541,263,110,20,41_denoise.png,1024,1448,651,283
9602,text,538,304,116,20,41_denoise.png,1024,1448,654,324
9603,text,541,325,194,20,41_denoise.png,1024,1448,735,345
9604,text,743,327,28,18,41_denoise.png,1024,1448,771,345
9605,text,54,384,200,24,41_denoise.png,1024,1448,254,408
9606,text,51,405,77,26,41_denoise.png,1024,1448,128,431
9607,text,99,459,82,20,41_denoise.png,1024,1448,181,479
9608,text,279,461,60,18,41_denoise.png,1024,1448,339,479
9609,text,431,461,72,20,41_denoise.png,1024,1448,503,481
9610,text,656,462,156,24,41_denoise.png,1024,1448,812,486
9611,text,93,489,96,20,41_denoise.png,1024,1448,189,509
9612,text,263,489,94,20,41_denoise.png,1024,1448,357,509
9613,text,423,491,88,20,41_denoise.png,1024,1448,511,511
9614,text,89,557,84,20,41_denoise.png,1024,1448,173,577
9615,text,286,558,98,20,41_denoise.png,1024,1448,384,578
9616,text,495,559,38,20,41_denoise.png,1024,1448,533,579
9617,text,571,559,54,20,41_denoise.png,1024,1448,625,579
9618,text,655,561,30,20,41_denoise.png,1024,1448,685,581
9619,text,785,565,68,16,41_denoise.png,1024,1448,853,581
9620,text,90,580,80,24,41_denoise.png,1024,1448,170,604
9621,text,255,583,162,20,41_denoise.png,1024,1448,417,603
9622,text,571,585,54,20,41_denoise.png,1024,1448,625,605
9623,text,659,587,24,18,41_denoise.png,1024,1448,683,605
9624,text,793,587,46,20,41_denoise.png,1024,1448,839,607
9625,text,91,607,76,20,41_denoise.png,1024,1448,167,627
9626,text,270,606,130,24,41_denoise.png,1024,1448,400,630
9627,text,575,609,46,20,41_denoise.png,1024,1448,621,629
9628,text,659,611,24,20,41_denoise.png,1024,1448,683,631
9629,text,795,613,44,18,41_denoise.png,1024,1448,839,631
9630,text,91,631,78,20,41_denoise.png,1024,1448,169,651
9631,text,247,633,176,20,41_denoise.png,1024,1448,423,653
9632,text,569,635,56,20,41_denoise.png,1024,1448,625,655
9633,text,659,635,22,20,41_denoise.png,1024,1448,681,655
9634,text,789,637,54,18,41_denoise.png,1024,1448,843,655
9635,text,107,1167,70,18,41_denoise.png,1024,1448,177,1185
9636,text,285,1167,50,20,41_denoise.png,1024,1448,335,1187
9637,text,465,1169,78,18,41_denoise.png,1024,1448,543,1187
9638,text,731,1169,78,20,41_denoise.png,1024,1448,809,1189
9639,text,113,1195,54,20,41_denoise.png,1024,1448,167,1215
9640,text,287,1197,46,20,41_denoise.png,1024,1448,333,1217
9641,text,481,1199,46,20,41_denoise.png,1024,1448,527,1219
9642,text,741,1199,54,20,41_denoise.png,1024,1448,795,1219
9643,text,54,1238,416,24,41_denoise.png,1024,1448,470,1262
9644,text,54,1258,446,24,41_denoise.png,1024,1448,500,1282
9645,text,407,1359,214,16,41_denoise.png,1024,1448,621,1375
9646,text,293,1377,144,16,41_denoise.png,1024,1448,437,1393
9647,text,447,1377,94,16,41_denoise.png,1024,1448,541,1393
9648,text,549,1377,38,14,41_denoise.png,1024,1448,587,1391
9649,text,595,1377,140,16,41_denoise.png,1024,1448,735,1393
9650,text,253,1397,70,14,41_denoise.png,1024,1448,323,1411
9651,text,351,1397,54,14,41_denoise.png,1024,1448,405,1411
9652,text,413,1397,46,14,41_denoise.png,1024,1448,459,1411
9653,text,465,1395,60,16,41_denoise.png,1024,1448,525,1411
9654,text,533,1395,34,16,41_denoise.png,1024,1448,567,1411
9655,text,573,1395,54,16,41_denoise.png,1024,1448,627,1411
9656,text,633,1395,24,16,41_denoise.png,1024,1448,657,1411
9657,text,663,1395,110,16,41_denoise.png,1024,1448,773,1411
9658,text,506,585,16,19,41_denoise.png,1024,1448,522,604
9659,text,506,610,15,18,41_denoise.png,1024,1448,521,628
9660,text,506,634,15,17,41_denoise.png,1024,1448,521,651
9661,text,332,1396,12,16,41_denoise.png,1024,1448,344,1412
9662,text,624,62,320,54,41_median.png,1024,1448,944,116
9663,text,539,241,155,24,41_median.png,1024,1448,694,265
9664,text,541,263,110,20,41_median.png,1024,1448,651,283
9665,text,538,304,116,20,41_median.png,1024,1448,654,324
9666,text,541,325,194,20,41_median.png,1024,1448,735,345
9667,text,743,327,28,18,41_median.png,1024,1448,771,345
9668,text,54,384,200,24,41_median.png,1024,1448,254,408
9669,text,51,405,77,26,41_median.png,1024,1448,128,431
9670,text,99,459,82,20,41_median.png,1024,1448,181,479
9671,text,279,461,60,18,41_median.png,1024,1448,339,479
9672,text,431,461,72,20,41_median.png,1024,1448,503,481
9673,text,656,462,156,24,41_median.png,1024,1448,812,486
9674,text,93,489,96,20,41_median.png,1024,1448,189,509
9675,text,263,489,94,20,41_median.png,1024,1448,357,509
9676,text,423,491,88,20,41_median.png,1024,1448,511,511
9677,text,89,557,84,20,41_median.png,1024,1448,173,577
9678,text,286,558,98,20,41_median.png,1024,1448,384,578
9679,text,495,559,38,20,41_median.png,1024,1448,533,579
9680,text,571,559,54,20,41_median.png,1024,1448,625,579
9681,text,655,561,30,20,41_median.png,1024,1448,685,581
9682,text,785,565,68,16,41_median.png,1024,1448,853,581
9683,text,90,580,80,24,41_median.png,1024,1448,170,604
9684,text,255,583,162,20,41_median.png,1024,1448,417,603
9685,text,571,585,54,20,41_median.png,1024,1448,625,605
9686,text,659,587,24,18,41_median.png,1024,1448,683,605
9687,text,793,587,46,20,41_median.png,1024,1448,839,607
9688,text,91,607,76,20,41_median.png,1024,1448,167,627
9689,text,270,606,130,24,41_median.png,1024,1448,400,630
9690,text,575,609,46,20,41_median.png,1024,1448,621,629
9691,text,659,611,24,20,41_median.png,1024,1448,683,631
9692,text,795,613,44,18,41_median.png,1024,1448,839,631
9693,text,91,631,78,20,41_median.png,1024,1448,169,651
9694,text,247,633,176,20,41_median.png,1024,1448,423,653
9695,text,569,635,56,20,41_median.png,1024,1448,625,655
9696,text,659,635,22,20,41_median.png,1024,1448,681,655
9697,text,789,637,54,18,41_median.png,1024,1448,843,655
9698,text,107,1167,70,18,41_median.png,1024,1448,177,1185
9699,text,285,1167,50,20,41_median.png,1024,1448,335,1187
9700,text,465,1169,78,18,41_median.png,1024,1448,543,1187
9701,text,731,1169,78,20,41_median.png,1024,1448,809,1189
9702,text,113,1195,54,20,41_median.png,1024,1448,167,1215
9703,text,287,1197,46,20,41_median.png,1024,1448,333,1217
9704,text,481,1199,46,20,41_median.png,1024,1448,527,1219
9705,text,741,1199,54,20,41_median.png,1024,1448,795,1219
9706,text,54,1238,416,24,41_median.png,1024,1448,470,1262
9707,text,54,1258,446,24,41_median.png,1024,1448,500,1282
9708,text,407,1359,214,16,41_median.png,1024,1448,621,1375
9709,text,293,1377,144,16,41_median.png,1024,1448,437,1393
9710,text,447,1377,94,16,41_median.png,1024,1448,541,1393
9711,text,549,1377,38,14,41_median.png,1024,1448,587,1391
9712,text,595,1377,140,16,41_median.png,1024,1448,735,1393
9713,text,253,1397,70,14,41_median.png,1024,1448,323,1411
9714,text,351,1397,54,14,41_median.png,1024,1448,405,1411
9715,text,413,1397,46,14,41_median.png,1024,1448,459,1411
9716,text,465,1395,60,16,41_median.png,1024,1448,525,1411
9717,text,533,1395,34,16,41_median.png,1024,1448,567,1411
9718,text,573,1395,54,16,41_median.png,1024,1448,627,1411
9719,text,633,1395,24,16,41_median.png,1024,1448,657,1411
9720,text,663,1395,110,16,41_median.png,1024,1448,773,1411
9721,text,506,585,16,19,41_median.png,1024,1448,522,604
9722,text,506,610,15,18,41_median.png,1024,1448,521,628
9723,text,506,634,15,17,41_median.png,1024,1448,521,651
9724,text,332,1396,12,16,41_median.png,1024,1448,344,1412
9725,text,366,61,312,62,42.png,1024,1448,678,123
9726,text,383,315,198,20,42.png,1024,1448,581,335
9727,text,131,415,140,40,42.png,1024,1448,271,455
9728,text,282,412,526,48,42.png,1024,1448,808,460
9729,text,380,466,196,24,42.png,1024,1448,576,490
9730,text,368,516,220,26,42.png,1024,1448,588,542
9731,text,206,568,104,26,42.png,1024,1448,310,594
9732,text,569,571,34,20,42.png,1024,1448,603,591
9733,text,654,570,82,24,42.png,1024,1448,736,594
9734,text,760,570,90,24,42.png,1024,1448,850,594
9735,text,126,670,258,25,42.png,1024,1448,384,695
9736,text,656,674,74,24,42.png,1024,1448,730,698
9737,text,766,674,74,24,42.png,1024,1448,840,698
9738,text,362,830,112,24,42.png,1024,1448,474,854
9739,text,764,832,74,24,42.png,1024,1448,838,856
9740,text,370,856,94,24,42.png,1024,1448,464,880
9741,text,768,856,64,29,42.png,1024,1448,832,885
9742,text,356,882,124,24,42.png,1024,1448,480,906
9743,text,764,884,72,24,42.png,1024,1448,836,908
9744,text,88,958,436,26,42.png,1024,1448,524,984
9745,text,89,985,74,20,42.png,1024,1448,163,1005
9746,text,173,985,116,20,42.png,1024,1448,289,1005
9747,text,298,984,174,24,42.png,1024,1448,472,1008
9748,text,485,987,120,20,42.png,1024,1448,605,1007
9749,text,148,1309,706,25,42.png,1024,1448,854,1334
9750,text,447,1335,106,20,42.png,1024,1448,553,1355
9751,text,246,1358,83,19,42.png,1024,1448,329,1377
9752,text,576,672,19,24,42.png,1024,1448,595,696
9753,text,465,674,21,24,42.png,1024,1448,486,698
9754,text,468,570,20,21,42.png,1024,1448,488,591
9755,text,335,1358,148,19,42.png,1024,1448,483,1377
9756,text,487,1358,94,20,42.png,1024,1448,581,1378
9757,text,584,1360,168,19,42.png,1024,1448,752,1379
9758,text,366,61,312,62,42_contrasted.png,1024,1448,678,123
9759,text,383,315,198,20,42_contrasted.png,1024,1448,581,335
9760,text,131,415,140,40,42_contrasted.png,1024,1448,271,455
9761,text,282,412,526,48,42_contrasted.png,1024,1448,808,460
9762,text,380,466,196,24,42_contrasted.png,1024,1448,576,490
9763,text,368,516,220,26,42_contrasted.png,1024,1448,588,542
9764,text,206,568,104,26,42_contrasted.png,1024,1448,310,594
9765,text,569,571,34,20,42_contrasted.png,1024,1448,603,591
9766,text,654,570,82,24,42_contrasted.png,1024,1448,736,594
9767,text,760,570,90,24,42_contrasted.png,1024,1448,850,594
9768,text,126,670,258,25,42_contrasted.png,1024,1448,384,695
9769,text,656,674,74,24,42_contrasted.png,1024,1448,730,698
9770,text,766,674,74,24,42_contrasted.png,1024,1448,840,698
9771,text,362,830,112,24,42_contrasted.png,1024,1448,474,854
9772,text,764,832,74,24,42_contrasted.png,1024,1448,838,856
9773,text,370,856,94,24,42_contrasted.png,1024,1448,464,880
9774,text,768,856,64,29,42_contrasted.png,1024,1448,832,885
9775,text,356,882,124,24,42_contrasted.png,1024,1448,480,906
9776,text,764,884,72,24,42_contrasted.png,1024,1448,836,908
9777,text,88,958,436,26,42_contrasted.png,1024,1448,524,984
9778,text,89,985,74,20,42_contrasted.png,1024,1448,163,1005
9779,text,173,985,116,20,42_contrasted.png,1024,1448,289,1005
9780,text,298,984,174,24,42_contrasted.png,1024,1448,472,1008
9781,text,485,987,120,20,42_contrasted.png,1024,1448,605,1007
9782,text,148,1309,706,25,42_contrasted.png,1024,1448,854,1334
9783,text,447,1335,106,20,42_contrasted.png,1024,1448,553,1355
9784,text,246,1358,83,19,42_contrasted.png,1024,1448,329,1377
9785,text,576,672,19,24,42_contrasted.png,1024,1448,595,696
9786,text,465,674,21,24,42_contrasted.png,1024,1448,486,698
9787,text,468,570,20,21,42_contrasted.png,1024,1448,488,591
9788,text,335,1358,148,19,42_contrasted.png,1024,1448,483,1377
9789,text,487,1358,94,20,42_contrasted.png,1024,1448,581,1378
9790,text,584,1360,168,19,42_contrasted.png,1024,1448,752,1379
9791,text,366,61,312,62,42_denoise.png,1024,1448,678,123
9792,text,383,315,198,20,42_denoise.png,1024,1448,581,335
9793,text,131,415,140,40,42_denoise.png,1024,1448,271,455
9794,text,282,412,526,48,42_denoise.png,1024,1448,808,460
9795,text,380,466,196,24,42_denoise.png,1024,1448,576,490
9796,text,368,516,220,26,42_denoise.png,1024,1448,588,542
9797,text,206,568,104,26,42_denoise.png,1024,1448,310,594
9798,text,569,571,34,20,42_denoise.png,1024,1448,603,591
9799,text,654,570,82,24,42_denoise.png,1024,1448,736,594
9800,text,760,570,90,24,42_denoise.png,1024,1448,850,594
9801,text,126,670,258,25,42_denoise.png,1024,1448,384,695
9802,text,656,674,74,24,42_denoise.png,1024,1448,730,698
9803,text,766,674,74,24,42_denoise.png,1024,1448,840,698
9804,text,362,830,112,24,42_denoise.png,1024,1448,474,854
9805,text,764,832,74,24,42_denoise.png,1024,1448,838,856
9806,text,370,856,94,24,42_denoise.png,1024,1448,464,880
9807,text,768,856,64,29,42_denoise.png,1024,1448,832,885
9808,text,356,882,124,24,42_denoise.png,1024,1448,480,906
9809,text,764,884,72,24,42_denoise.png,1024,1448,836,908
9810,text,88,958,436,26,42_denoise.png,1024,1448,524,984
9811,text,89,985,74,20,42_denoise.png,1024,1448,163,1005
9812,text,173,985,116,20,42_denoise.png,1024,1448,289,1005
9813,text,298,984,174,24,42_denoise.png,1024,1448,472,1008
9814,text,485,987,120,20,42_denoise.png,1024,1448,605,1007
9815,text,148,1309,706,25,42_denoise.png,1024,1448,854,1334
9816,text,447,1335,106,20,42_denoise.png,1024,1448,553,1355
9817,text,246,1358,83,19,42_denoise.png,1024,1448,329,1377
9818,text,576,672,19,24,42_denoise.png,1024,1448,595,696
9819,text,465,674,21,24,42_denoise.png,1024,1448,486,698
9820,text,468,570,20,21,42_denoise.png,1024,1448,488,591
9821,text,335,1358,148,19,42_denoise.png,1024,1448,483,1377
9822,text,487,1358,94,20,42_denoise.png,1024,1448,581,1378
9823,text,584,1360,168,19,42_denoise.png,1024,1448,752,1379
9824,text,366,61,312,62,42_median.png,1024,1448,678,123
9825,text,383,315,198,20,42_median.png,1024,1448,581,335
9826,text,131,415,140,40,42_median.png,1024,1448,271,455
9827,text,282,412,526,48,42_median.png,1024,1448,808,460
9828,text,380,466,196,24,42_median.png,1024,1448,576,490
9829,text,368,516,220,26,42_median.png,1024,1448,588,542
9830,text,206,568,104,26,42_median.png,1024,1448,310,594
9831,text,569,571,34,20,42_median.png,1024,1448,603,591
9832,text,654,570,82,24,42_median.png,1024,1448,736,594
9833,text,760,570,90,24,42_median.png,1024,1448,850,594
9834,text,126,670,258,25,42_median.png,1024,1448,384,695
9835,text,656,674,74,24,42_median.png,1024,1448,730,698
9836,text,766,674,74,24,42_median.png,1024,1448,840,698
9837,text,362,830,112,24,42_median.png,1024,1448,474,854
9838,text,764,832,74,24,42_median.png,1024,1448,838,856
9839,text,370,856,94,24,42_median.png,1024,1448,464,880
9840,text,768,856,64,29,42_median.png,1024,1448,832,885
9841,text,356,882,124,24,42_median.png,1024,1448,480,906
9842,text,764,884,72,24,42_median.png,1024,1448,836,908
9843,text,88,958,436,26,42_median.png,1024,1448,524,984
9844,text,89,985,74,20,42_median.png,1024,1448,163,1005
9845,text,173,985,116,20,42_median.png,1024,1448,289,1005
9846,text,298,984,174,24,42_median.png,1024,1448,472,1008
9847,text,485,987,120,20,42_median.png,1024,1448,605,1007
9848,text,148,1309,706,25,42_median.png,1024,1448,854,1334
9849,text,447,1335,106,20,42_median.png,1024,1448,553,1355
9850,text,246,1358,83,19,42_median.png,1024,1448,329,1377
9851,text,576,672,19,24,42_median.png,1024,1448,595,696
9852,text,465,674,21,24,42_median.png,1024,1448,486,698
9853,text,468,570,20,21,42_median.png,1024,1448,488,591
9854,text,335,1358,148,19,42_median.png,1024,1448,483,1377
9855,text,487,1358,94,20,42_median.png,1024,1448,581,1378
9856,text,584,1360,168,19,42_median.png,1024,1448,752,1379
9857,text,26,18,382,126,44.png,1024,1448,408,144
9858,text,484,80,52,26,44.png,1024,1448,536,106
9859,text,880,84,104,24,44.png,1024,1448,984,108
9860,text,38,136,318,24,44.png,1024,1448,356,160
9861,text,482,134,202,26,44.png,1024,1448,684,160
9862,text,38,164,374,26,44.png,1024,1448,412,190
9863,text,482,164,70,28,44.png,1024,1448,552,192
9864,text,574,164,360,26,44.png,1024,1448,934,190
9865,text,39,195,28,20,44.png,1024,1448,67,215
9866,text,78,194,178,24,44.png,1024,1448,256,218
9867,text,263,197,128,20,44.png,1024,1448,391,217
9868,text,480,192,76,28,44.png,1024,1448,556,220
9869,text,571,192,184,28,44.png,1024,1448,755,220
9870,text,37,225,32,20,44.png,1024,1448,69,245
9871,text,76,224,286,24,44.png,1024,1448,362,248
9872,text,480,222,78,26,44.png,1024,1448,558,248
9873,text,37,251,48,20,44.png,1024,1448,85,271
9874,text,97,251,216,20,44.png,1024,1448,313,271
9875,text,36,274,238,24,44.png,1024,1448,274,298
9876,text,37,299,28,18,44.png,1024,1448,65,317
9877,text,76,296,286,24,44.png,1024,1448,362,320
9878,text,37,325,32,16,44.png,1024,1448,69,341
9879,text,77,323,112,20,44.png,1024,1448,189,343
9880,text,34,344,288,24,44.png,1024,1448,322,368
9881,text,34,368,97,24,44.png,1024,1448,131,392
9882,text,35,393,128,20,44.png,1024,1448,163,413
9883,text,171,395,148,20,44.png,1024,1448,319,415
9884,text,33,417,176,20,44.png,1024,1448,209,437
9885,text,155,443,114,20,44.png,1024,1448,269,463
9886,text,75,465,110,20,44.png,1024,1448,185,485
9887,text,285,467,44,20,44.png,1024,1448,329,487
9888,text,259,489,92,20,44.png,1024,1448,351,509
9889,text,49,507,158,20,44.png,1024,1448,207,527
9890,text,258,509,92,20,44.png,1024,1448,350,529
9891,text,103,531,50,20,44.png,1024,1448,153,551
9892,text,259,529,90,20,44.png,1024,1448,349,549
9893,text,261,551,88,20,44.png,1024,1448,349,571
9894,text,37,585,76,20,44.png,1024,1448,113,605
9895,text,197,583,109,28,44.png,1024,1448,306,611
9896,text,424,576,102,24,44.png,1024,1448,526,600
9897,text,636,576,112,24,44.png,1024,1448,748,600
9898,text,849,579,48,20,44.png,1024,1448,897,599
9899,text,392,598,76,24,44.png,1024,1448,468,622
9900,text,481,599,75,26,44.png,1024,1448,556,625
9901,text,583,601,30,20,44.png,1024,1448,613,621
9902,text,683,601,36,20,44.png,1024,1448,719,621
9903,text,855,601,34,20,44.png,1024,1448,889,621
9904,text,76,620,36,24,44.png,1024,1448,112,644
9905,text,696,624,66,24,44.png,1024,1448,762,648
9906,text,880,626,94,24,44.png,1024,1448,974,650
9907,text,76,644,35,26,44.png,1024,1448,111,670
9908,text,695,651,64,20,44.png,1024,1448,759,671
9909,text,868,650,106,24,44.png,1024,1448,974,674
9910,text,928,676,44,24,44.png,1024,1448,972,700
9911,text,928,700,44,24,44.png,1024,1448,972,724
9912,text,927,727,44,20,44.png,1024,1448,971,747
9913,text,926,750,44,24,44.png,1024,1448,970,774
9914,text,926,776,44,24,44.png,1024,1448,970,800
9915,text,927,803,42,20,44.png,1024,1448,969,823
9916,text,927,827,42,20,44.png,1024,1448,969,847
9917,text,925,853,44,20,44.png,1024,1448,969,873
9918,text,924,876,46,24,44.png,1024,1448,970,900
9919,text,925,903,42,20,44.png,1024,1448,967,923
9920,text,924,926,44,24,44.png,1024,1448,968,950
9921,text,926,952,42,24,44.png,1024,1448,968,976
9922,text,924,976,44,24,44.png,1024,1448,968,1000
9923,text,922,1002,44,24,44.png,1024,1448,966,1026
9924,text,922,1026,44,24,44.png,1024,1448,966,1050
9925,text,630,1054,88,24,44.png,1024,1448,718,1078
9926,text,846,1052,120,26,44.png,1024,1448,966,1078
9927,text,630,1084,102,24,44.png,1024,1448,732,1108
9928,text,856,1082,106,26,44.png,1024,1448,962,1108
9929,text,27,1111,104,20,44.png,1024,1448,131,1131
9930,text,629,1113,102,20,44.png,1024,1448,731,1133
9931,text,844,1110,120,26,44.png,1024,1448,964,1136
9932,text,26,1136,404,26,44.png,1024,1448,430,1162
9933,text,472,1139,472,28,44.png,1024,1448,944,1167
9934,text,22,1160,146,29,44.png,1024,1448,168,1189
9935,text,346,1192,298,24,44.png,1024,1448,644,1216
9936,text,32,1242,794,24,44.png,1024,1448,826,1266
9937,text,831,1247,130,18,44.png,1024,1448,961,1265
9938,text,73,1263,233,18,44.png,1024,1448,306,1281
9939,text,309,1265,208,18,44.png,1024,1448,517,1283
9940,text,523,1265,396,18,44.png,1024,1448,919,1283
9941,text,424,1143,50,24,44.png,1024,1448,474,1167
9942,text,303,1110,19,23,44.png,1024,1448,322,1133
9943,text,140,371,233,18,44.png,1024,1448,373,389
9944,text,122,623,136,20,44.png,1024,1448,258,643
9945,text,119,648,149,21,44.png,1024,1448,268,669
9946,text,26,18,382,126,44_contrasted.png,1024,1448,408,144
9947,text,484,80,52,26,44_contrasted.png,1024,1448,536,106
9948,text,880,84,104,24,44_contrasted.png,1024,1448,984,108
9949,text,38,136,318,24,44_contrasted.png,1024,1448,356,160
9950,text,482,134,202,26,44_contrasted.png,1024,1448,684,160
9951,text,38,164,374,26,44_contrasted.png,1024,1448,412,190
9952,text,482,164,70,28,44_contrasted.png,1024,1448,552,192
9953,text,574,164,360,26,44_contrasted.png,1024,1448,934,190
9954,text,39,195,28,20,44_contrasted.png,1024,1448,67,215
9955,text,78,194,178,24,44_contrasted.png,1024,1448,256,218
9956,text,263,197,128,20,44_contrasted.png,1024,1448,391,217
9957,text,480,192,76,28,44_contrasted.png,1024,1448,556,220
9958,text,571,192,184,28,44_contrasted.png,1024,1448,755,220
9959,text,37,225,32,20,44_contrasted.png,1024,1448,69,245
9960,text,76,224,286,24,44_contrasted.png,1024,1448,362,248
9961,text,480,222,78,26,44_contrasted.png,1024,1448,558,248
9962,text,37,251,48,20,44_contrasted.png,1024,1448,85,271
9963,text,97,251,216,20,44_contrasted.png,1024,1448,313,271
9964,text,36,274,238,24,44_contrasted.png,1024,1448,274,298
9965,text,37,299,28,18,44_contrasted.png,1024,1448,65,317
9966,text,76,296,286,24,44_contrasted.png,1024,1448,362,320
9967,text,37,325,32,16,44_contrasted.png,1024,1448,69,341
9968,text,77,323,112,20,44_contrasted.png,1024,1448,189,343
9969,text,34,344,288,24,44_contrasted.png,1024,1448,322,368
9970,text,34,368,97,24,44_contrasted.png,1024,1448,131,392
9971,text,35,393,128,20,44_contrasted.png,1024,1448,163,413
9972,text,171,395,148,20,44_contrasted.png,1024,1448,319,415
9973,text,33,417,176,20,44_contrasted.png,1024,1448,209,437
9974,text,155,443,114,20,44_contrasted.png,1024,1448,269,463
9975,text,75,465,110,20,44_contrasted.png,1024,1448,185,485
9976,text,285,467,44,20,44_contrasted.png,1024,1448,329,487
9977,text,259,489,92,20,44_contrasted.png,1024,1448,351,509
9978,text,49,507,158,20,44_contrasted.png,1024,1448,207,527
9979,text,258,509,92,20,44_contrasted.png,1024,1448,350,529
9980,text,103,531,50,20,44_contrasted.png,1024,1448,153,551
9981,text,259,529,90,20,44_contrasted.png,1024,1448,349,549
9982,text,261,551,88,20,44_contrasted.png,1024,1448,349,571
9983,text,37,585,76,20,44_contrasted.png,1024,1448,113,605
9984,text,197,583,109,28,44_contrasted.png,1024,1448,306,611
9985,text,424,576,102,24,44_contrasted.png,1024,1448,526,600
9986,text,636,576,112,24,44_contrasted.png,1024,1448,748,600
9987,text,849,579,48,20,44_contrasted.png,1024,1448,897,599
9988,text,392,598,76,24,44_contrasted.png,1024,1448,468,622
9989,text,481,599,75,26,44_contrasted.png,1024,1448,556,625
9990,text,583,601,30,20,44_contrasted.png,1024,1448,613,621
9991,text,683,601,36,20,44_contrasted.png,1024,1448,719,621
9992,text,855,601,34,20,44_contrasted.png,1024,1448,889,621
9993,text,76,620,36,24,44_contrasted.png,1024,1448,112,644
9994,text,696,624,66,24,44_contrasted.png,1024,1448,762,648
9995,text,880,626,94,24,44_contrasted.png,1024,1448,974,650
9996,text,76,644,35,26,44_contrasted.png,1024,1448,111,670
9997,text,695,651,64,20,44_contrasted.png,1024,1448,759,671
9998,text,868,650,106,24,44_contrasted.png,1024,1448,974,674
9999,text,928,676,44,24,44_contrasted.png,1024,1448,972,700
10000,text,928,700,44,24,44_contrasted.png,1024,1448,972,724
10001,text,927,727,44,20,44_contrasted.png,1024,1448,971,747
10002,text,926,750,44,24,44_contrasted.png,1024,1448,970,774
10003,text,926,776,44,24,44_contrasted.png,1024,1448,970,800
10004,text,927,803,42,20,44_contrasted.png,1024,1448,969,823
10005,text,927,827,42,20,44_contrasted.png,1024,1448,969,847
10006,text,925,853,44,20,44_contrasted.png,1024,1448,969,873
10007,text,924,876,46,24,44_contrasted.png,1024,1448,970,900
10008,text,925,903,42,20,44_contrasted.png,1024,1448,967,923
10009,text,924,926,44,24,44_contrasted.png,1024,1448,968,950
10010,text,926,952,42,24,44_contrasted.png,1024,1448,968,976
10011,text,924,976,44,24,44_contrasted.png,1024,1448,968,1000
10012,text,922,1002,44,24,44_contrasted.png,1024,1448,966,1026
10013,text,922,1026,44,24,44_contrasted.png,1024,1448,966,1050
10014,text,630,1054,88,24,44_contrasted.png,1024,1448,718,1078
10015,text,846,1052,120,26,44_contrasted.png,1024,1448,966,1078
10016,text,630,1084,102,24,44_contrasted.png,1024,1448,732,1108
10017,text,856,1082,106,26,44_contrasted.png,1024,1448,962,1108
10018,text,27,1111,104,20,44_contrasted.png,1024,1448,131,1131
10019,text,629,1113,102,20,44_contrasted.png,1024,1448,731,1133
10020,text,844,1110,120,26,44_contrasted.png,1024,1448,964,1136
10021,text,26,1136,404,26,44_contrasted.png,1024,1448,430,1162
10022,text,472,1139,472,28,44_contrasted.png,1024,1448,944,1167
10023,text,22,1160,146,29,44_contrasted.png,1024,1448,168,1189
10024,text,346,1192,298,24,44_contrasted.png,1024,1448,644,1216
10025,text,32,1242,794,24,44_contrasted.png,1024,1448,826,1266
10026,text,831,1247,130,18,44_contrasted.png,1024,1448,961,1265
10027,text,73,1263,233,18,44_contrasted.png,1024,1448,306,1281
10028,text,309,1265,208,18,44_contrasted.png,1024,1448,517,1283
10029,text,523,1265,396,18,44_contrasted.png,1024,1448,919,1283
10030,text,424,1143,50,24,44_contrasted.png,1024,1448,474,1167
10031,text,303,1110,19,23,44_contrasted.png,1024,1448,322,1133
10032,text,140,371,233,18,44_contrasted.png,1024,1448,373,389
10033,text,122,623,136,20,44_contrasted.png,1024,1448,258,643
10034,text,119,648,149,21,44_contrasted.png,1024,1448,268,669
10035,text,26,18,382,126,44_denoise.png,1024,1448,408,144
10036,text,484,80,52,26,44_denoise.png,1024,1448,536,106
10037,text,880,84,104,24,44_denoise.png,1024,1448,984,108
10038,text,38,136,318,24,44_denoise.png,1024,1448,356,160
10039,text,482,134,202,26,44_denoise.png,1024,1448,684,160
10040,text,38,164,374,26,44_denoise.png,1024,1448,412,190
10041,text,482,164,70,28,44_denoise.png,1024,1448,552,192
10042,text,574,164,360,26,44_denoise.png,1024,1448,934,190
10043,text,39,195,28,20,44_denoise.png,1024,1448,67,215
10044,text,78,194,178,24,44_denoise.png,1024,1448,256,218
10045,text,263,197,128,20,44_denoise.png,1024,1448,391,217
10046,text,480,192,76,28,44_denoise.png,1024,1448,556,220
10047,text,571,192,184,28,44_denoise.png,1024,1448,755,220
10048,text,37,225,32,20,44_denoise.png,1024,1448,69,245
10049,text,76,224,286,24,44_denoise.png,1024,1448,362,248
10050,text,480,222,78,26,44_denoise.png,1024,1448,558,248
10051,text,37,251,48,20,44_denoise.png,1024,1448,85,271
10052,text,97,251,216,20,44_denoise.png,1024,1448,313,271
10053,text,36,274,238,24,44_denoise.png,1024,1448,274,298
10054,text,37,299,28,18,44_denoise.png,1024,1448,65,317
10055,text,76,296,286,24,44_denoise.png,1024,1448,362,320
10056,text,37,325,32,16,44_denoise.png,1024,1448,69,341
10057,text,77,323,112,20,44_denoise.png,1024,1448,189,343
10058,text,34,344,288,24,44_denoise.png,1024,1448,322,368
10059,text,34,368,97,24,44_denoise.png,1024,1448,131,392
10060,text,35,393,128,20,44_denoise.png,1024,1448,163,413
10061,text,171,395,148,20,44_denoise.png,1024,1448,319,415
10062,text,33,417,176,20,44_denoise.png,1024,1448,209,437
10063,text,155,443,114,20,44_denoise.png,1024,1448,269,463
10064,text,75,465,110,20,44_denoise.png,1024,1448,185,485
10065,text,285,467,44,20,44_denoise.png,1024,1448,329,487
10066,text,259,489,92,20,44_denoise.png,1024,1448,351,509
10067,text,49,507,158,20,44_denoise.png,1024,1448,207,527
10068,text,258,509,92,20,44_denoise.png,1024,1448,350,529
10069,text,103,531,50,20,44_denoise.png,1024,1448,153,551
10070,text,259,529,90,20,44_denoise.png,1024,1448,349,549
10071,text,261,551,88,20,44_denoise.png,1024,1448,349,571
10072,text,37,585,76,20,44_denoise.png,1024,1448,113,605
10073,text,197,583,109,28,44_denoise.png,1024,1448,306,611
10074,text,424,576,102,24,44_denoise.png,1024,1448,526,600
10075,text,636,576,112,24,44_denoise.png,1024,1448,748,600
10076,text,849,579,48,20,44_denoise.png,1024,1448,897,599
10077,text,392,598,76,24,44_denoise.png,1024,1448,468,622
10078,text,481,599,75,26,44_denoise.png,1024,1448,556,625
10079,text,583,601,30,20,44_denoise.png,1024,1448,613,621
10080,text,683,601,36,20,44_denoise.png,1024,1448,719,621
10081,text,855,601,34,20,44_denoise.png,1024,1448,889,621
10082,text,76,620,36,24,44_denoise.png,1024,1448,112,644
10083,text,696,624,66,24,44_denoise.png,1024,1448,762,648
10084,text,880,626,94,24,44_denoise.png,1024,1448,974,650
10085,text,76,644,35,26,44_denoise.png,1024,1448,111,670
10086,text,695,651,64,20,44_denoise.png,1024,1448,759,671
10087,text,868,650,106,24,44_denoise.png,1024,1448,974,674
10088,text,928,676,44,24,44_denoise.png,1024,1448,972,700
10089,text,928,700,44,24,44_denoise.png,1024,1448,972,724
10090,text,927,727,44,20,44_denoise.png,1024,1448,971,747
10091,text,926,750,44,24,44_denoise.png,1024,1448,970,774
10092,text,926,776,44,24,44_denoise.png,1024,1448,970,800
10093,text,927,803,42,20,44_denoise.png,1024,1448,969,823
10094,text,927,827,42,20,44_denoise.png,1024,1448,969,847
10095,text,925,853,44,20,44_denoise.png,1024,1448,969,873
10096,text,924,876,46,24,44_denoise.png,1024,1448,970,900
10097,text,925,903,42,20,44_denoise.png,1024,1448,967,923
10098,text,924,926,44,24,44_denoise.png,1024,1448,968,950
10099,text,926,952,42,24,44_denoise.png,1024,1448,968,976
10100,text,924,976,44,24,44_denoise.png,1024,1448,968,1000
10101,text,922,1002,44,24,44_denoise.png,1024,1448,966,1026
10102,text,922,1026,44,24,44_denoise.png,1024,1448,966,1050
10103,text,630,1054,88,24,44_denoise.png,1024,1448,718,1078
10104,text,846,1052,120,26,44_denoise.png,1024,1448,966,1078
10105,text,630,1084,102,24,44_denoise.png,1024,1448,732,1108
10106,text,856,1082,106,26,44_denoise.png,1024,1448,962,1108
10107,text,27,1111,104,20,44_denoise.png,1024,1448,131,1131
10108,text,629,1113,102,20,44_denoise.png,1024,1448,731,1133
10109,text,844,1110,120,26,44_denoise.png,1024,1448,964,1136
10110,text,26,1136,404,26,44_denoise.png,1024,1448,430,1162
10111,text,472,1139,472,28,44_denoise.png,1024,1448,944,1167
10112,text,22,1160,146,29,44_denoise.png,1024,1448,168,1189
10113,text,346,1192,298,24,44_denoise.png,1024,1448,644,1216
10114,text,32,1242,794,24,44_denoise.png,1024,1448,826,1266
10115,text,831,1247,130,18,44_denoise.png,1024,1448,961,1265
10116,text,73,1263,233,18,44_denoise.png,1024,1448,306,1281
10117,text,309,1265,208,18,44_denoise.png,1024,1448,517,1283
10118,text,523,1265,396,18,44_denoise.png,1024,1448,919,1283
10119,text,424,1143,50,24,44_denoise.png,1024,1448,474,1167
10120,text,303,1110,19,23,44_denoise.png,1024,1448,322,1133
10121,text,140,371,233,18,44_denoise.png,1024,1448,373,389
10122,text,122,623,136,20,44_denoise.png,1024,1448,258,643
10123,text,119,648,149,21,44_denoise.png,1024,1448,268,669
10124,text,26,18,382,126,44_median.png,1024,1448,408,144
10125,text,484,80,52,26,44_median.png,1024,1448,536,106
10126,text,880,84,104,24,44_median.png,1024,1448,984,108
10127,text,38,136,318,24,44_median.png,1024,1448,356,160
10128,text,482,134,202,26,44_median.png,1024,1448,684,160
10129,text,38,164,374,26,44_median.png,1024,1448,412,190
10130,text,482,164,70,28,44_median.png,1024,1448,552,192
10131,text,574,164,360,26,44_median.png,1024,1448,934,190
10132,text,39,195,28,20,44_median.png,1024,1448,67,215
10133,text,78,194,178,24,44_median.png,1024,1448,256,218
10134,text,263,197,128,20,44_median.png,1024,1448,391,217
10135,text,480,192,76,28,44_median.png,1024,1448,556,220
10136,text,571,192,184,28,44_median.png,1024,1448,755,220
10137,text,37,225,32,20,44_median.png,1024,1448,69,245
10138,text,76,224,286,24,44_median.png,1024,1448,362,248
10139,text,480,222,78,26,44_median.png,1024,1448,558,248
10140,text,37,251,48,20,44_median.png,1024,1448,85,271
10141,text,97,251,216,20,44_median.png,1024,1448,313,271
10142,text,36,274,238,24,44_median.png,1024,1448,274,298
10143,text,37,299,28,18,44_median.png,1024,1448,65,317
10144,text,76,296,286,24,44_median.png,1024,1448,362,320
10145,text,37,325,32,16,44_median.png,1024,1448,69,341
10146,text,77,323,112,20,44_median.png,1024,1448,189,343
10147,text,34,344,288,24,44_median.png,1024,1448,322,368
10148,text,34,368,97,24,44_median.png,1024,1448,131,392
10149,text,35,393,128,20,44_median.png,1024,1448,163,413
10150,text,171,395,148,20,44_median.png,1024,1448,319,415
10151,text,33,417,176,20,44_median.png,1024,1448,209,437
10152,text,155,443,114,20,44_median.png,1024,1448,269,463
10153,text,75,465,110,20,44_median.png,1024,1448,185,485
10154,text,285,467,44,20,44_median.png,1024,1448,329,487
10155,text,259,489,92,20,44_median.png,1024,1448,351,509
10156,text,49,507,158,20,44_median.png,1024,1448,207,527
10157,text,258,509,92,20,44_median.png,1024,1448,350,529
10158,text,103,531,50,20,44_median.png,1024,1448,153,551
10159,text,259,529,90,20,44_median.png,1024,1448,349,549
10160,text,261,551,88,20,44_median.png,1024,1448,349,571
10161,text,37,585,76,20,44_median.png,1024,1448,113,605
10162,text,197,583,109,28,44_median.png,1024,1448,306,611
10163,text,424,576,102,24,44_median.png,1024,1448,526,600
10164,text,636,576,112,24,44_median.png,1024,1448,748,600
10165,text,849,579,48,20,44_median.png,1024,1448,897,599
10166,text,392,598,76,24,44_median.png,1024,1448,468,622
10167,text,481,599,75,26,44_median.png,1024,1448,556,625
10168,text,583,601,30,20,44_median.png,1024,1448,613,621
10169,text,683,601,36,20,44_median.png,1024,1448,719,621
10170,text,855,601,34,20,44_median.png,1024,1448,889,621
10171,text,76,620,36,24,44_median.png,1024,1448,112,644
10172,text,696,624,66,24,44_median.png,1024,1448,762,648
10173,text,880,626,94,24,44_median.png,1024,1448,974,650
10174,text,76,644,35,26,44_median.png,1024,1448,111,670
10175,text,695,651,64,20,44_median.png,1024,1448,759,671
10176,text,868,650,106,24,44_median.png,1024,1448,974,674
10177,text,928,676,44,24,44_median.png,1024,1448,972,700
10178,text,928,700,44,24,44_median.png,1024,1448,972,724
10179,text,927,727,44,20,44_median.png,1024,1448,971,747
10180,text,926,750,44,24,44_median.png,1024,1448,970,774
10181,text,926,776,44,24,44_median.png,1024,1448,970,800
10182,text,927,803,42,20,44_median.png,1024,1448,969,823
10183,text,927,827,42,20,44_median.png,1024,1448,969,847
10184,text,925,853,44,20,44_median.png,1024,1448,969,873
10185,text,924,876,46,24,44_median.png,1024,1448,970,900
10186,text,925,903,42,20,44_median.png,1024,1448,967,923
10187,text,924,926,44,24,44_median.png,1024,1448,968,950
10188,text,926,952,42,24,44_median.png,1024,1448,968,976
10189,text,924,976,44,24,44_median.png,1024,1448,968,1000
10190,text,922,1002,44,24,44_median.png,1024,1448,966,1026
10191,text,922,1026,44,24,44_median.png,1024,1448,966,1050
10192,text,630,1054,88,24,44_median.png,1024,1448,718,1078
10193,text,846,1052,120,26,44_median.png,1024,1448,966,1078
10194,text,630,1084,102,24,44_median.png,1024,1448,732,1108
10195,text,856,1082,106,26,44_median.png,1024,1448,962,1108
10196,text,27,1111,104,20,44_median.png,1024,1448,131,1131
10197,text,629,1113,102,20,44_median.png,1024,1448,731,1133
10198,text,844,1110,120,26,44_median.png,1024,1448,964,1136
10199,text,26,1136,404,26,44_median.png,1024,1448,430,1162
10200,text,472,1139,472,28,44_median.png,1024,1448,944,1167
10201,text,22,1160,146,29,44_median.png,1024,1448,168,1189
10202,text,346,1192,298,24,44_median.png,1024,1448,644,1216
10203,text,32,1242,794,24,44_median.png,1024,1448,826,1266
10204,text,831,1247,130,18,44_median.png,1024,1448,961,1265
10205,text,73,1263,233,18,44_median.png,1024,1448,306,1281
10206,text,309,1265,208,18,44_median.png,1024,1448,517,1283
10207,text,523,1265,396,18,44_median.png,1024,1448,919,1283
10208,text,424,1143,50,24,44_median.png,1024,1448,474,1167
10209,text,303,1110,19,23,44_median.png,1024,1448,322,1133
10210,text,140,371,233,18,44_median.png,1024,1448,373,389
10211,text,122,623,136,20,44_median.png,1024,1448,258,643
10212,text,119,648,149,21,44_median.png,1024,1448,268,669
10213,text,146,95,212,42,45.png,1024,1448,358,137
10214,text,526,216,258,24,45.png,1024,1448,784,240
10215,text,527,241,158,20,45.png,1024,1448,685,261
10216,text,527,289,84,20,45.png,1024,1448,611,309
10217,text,92,358,104,24,45.png,1024,1448,196,382
10218,text,204,357,102,24,45.png,1024,1448,306,381
10219,text,94,382,66,24,45.png,1024,1448,160,406
10220,text,204,382,92,24,45.png,1024,1448,296,406
10221,text,95,409,84,20,45.png,1024,1448,179,429
10222,text,205,409,92,20,45.png,1024,1448,297,429
10223,text,343,409,110,20,45.png,1024,1448,453,429
10224,text,493,409,84,20,45.png,1024,1448,577,429
10225,text,627,409,132,20,45.png,1024,1448,759,429
10226,text,781,409,94,20,45.png,1024,1448,875,429
10227,text,92,484,55,17,45.png,1024,1448,147,501
10228,text,515,485,72,14,45.png,1024,1448,587,499
10229,text,637,485,30,14,45.png,1024,1448,667,499
10230,text,689,485,74,14,45.png,1024,1448,763,499
10231,text,791,485,78,14,45.png,1024,1448,869,499
10232,text,513,509,34,14,45.png,1024,1448,547,523
10233,text,689,509,32,14,45.png,1024,1448,721,523
10234,text,791,509,34,14,45.png,1024,1448,825,523
10235,text,92,532,47,18,45.png,1024,1448,139,550
10236,text,555,533,69,14,45.png,1024,1448,624,547
10237,text,721,533,52,16,45.png,1024,1448,773,549
10238,text,833,533,68,16,45.png,1024,1448,901,549
10239,text,93,559,78,14,45.png,1024,1448,171,573
10240,text,199,557,54,14,45.png,1024,1448,253,571
10241,text,579,557,44,16,45.png,1024,1448,623,573
10242,text,857,557,44,16,45.png,1024,1448,901,573
10243,text,453,581,44,16,45.png,1024,1448,497,597
10244,text,555,581,68,16,45.png,1024,1448,623,597
10245,text,725,581,52,16,45.png,1024,1448,777,597
10246,text,833,581,68,16,45.png,1024,1448,901,597
10247,text,523,653,30,14,45.png,1024,1448,553,667
10248,text,595,653,72,14,45.png,1024,1448,667,667
10249,text,707,653,74,14,45.png,1024,1448,781,667
10250,text,811,653,76,14,45.png,1024,1448,887,667
10251,text,611,677,60,16,45.png,1024,1448,671,693
10252,text,727,677,44,14,45.png,1024,1448,771,691
10253,text,826,677,60,14,45.png,1024,1448,886,691
10254,text,631,701,40,14,45.png,1024,1448,671,715
10255,text,847,701,40,14,45.png,1024,1448,887,715
10256,text,479,1131,44,16,45.png,1024,1448,523,1147
10257,text,681,1131,72,16,45.png,1024,1448,753,1147
10258,text,477,1155,60,16,45.png,1024,1448,537,1171
10259,text,681,1155,74,16,45.png,1024,1448,755,1171
10260,text,477,1177,86,18,45.png,1024,1448,563,1195
10261,text,681,1179,88,16,45.png,1024,1448,769,1195
10262,text,515,1203,72,16,45.png,1024,1448,587,1219
10263,text,591,1205,30,12,45.png,1024,1448,621,1217
10264,text,739,1203,52,16,45.png,1024,1448,791,1219
10265,text,797,1205,28,14,45.png,1024,1448,825,1219
10266,text,19,1385,178,14,45.png,1024,1448,197,1399
10267,text,205,1383,36,16,45.png,1024,1448,241,1399
10268,text,247,1383,202,16,45.png,1024,1448,449,1399
10269,text,455,1383,120,16,45.png,1024,1448,575,1399
10270,text,581,1385,106,14,45.png,1024,1448,687,1399
10271,text,691,1385,40,14,45.png,1024,1448,731,1399
10272,text,737,1383,122,18,45.png,1024,1448,859,1401
10273,text,893,1385,98,16,45.png,1024,1448,991,1401
10274,text,359,1405,94,14,45.png,1024,1448,453,1419
10275,text,457,1405,52,14,45.png,1024,1448,509,1419
10276,text,513,1405,30,14,45.png,1024,1448,543,1419
10277,text,666,1404,124,15,45.png,1024,1448,790,1419
10278,text,795,1407,76,14,45.png,1024,1448,871,1421
10279,text,865,1387,24,14,45.png,1024,1448,889,1401
10280,text,175,556,19,16,45.png,1024,1448,194,572
10281,text,637,531,42,16,45.png,1024,1448,679,547
10282,text,643,556,34,15,45.png,1024,1448,677,571
10283,text,737,555,38,17,45.png,1024,1448,775,572
10284,text,740,701,33,12,45.png,1024,1448,773,713
10285,text,518,701,33,12,45.png,1024,1448,551,713
10286,text,511,677,42,13,45.png,1024,1448,553,690
10287,text,596,1404,65,14,45.png,1024,1448,661,1418
10288,text,547,1404,44,14,45.png,1024,1448,591,1418
10289,text,146,95,212,42,45_contrasted.png,1024,1448,358,137
10290,text,526,216,258,24,45_contrasted.png,1024,1448,784,240
10291,text,527,241,158,20,45_contrasted.png,1024,1448,685,261
10292,text,527,289,84,20,45_contrasted.png,1024,1448,611,309
10293,text,92,358,104,24,45_contrasted.png,1024,1448,196,382
10294,text,204,357,102,24,45_contrasted.png,1024,1448,306,381
10295,text,94,382,66,24,45_contrasted.png,1024,1448,160,406
10296,text,204,382,92,24,45_contrasted.png,1024,1448,296,406
10297,text,95,409,84,20,45_contrasted.png,1024,1448,179,429
10298,text,205,409,92,20,45_contrasted.png,1024,1448,297,429
10299,text,343,409,110,20,45_contrasted.png,1024,1448,453,429
10300,text,493,409,84,20,45_contrasted.png,1024,1448,577,429
10301,text,627,409,132,20,45_contrasted.png,1024,1448,759,429
10302,text,781,409,94,20,45_contrasted.png,1024,1448,875,429
10303,text,92,484,55,17,45_contrasted.png,1024,1448,147,501
10304,text,515,485,72,14,45_contrasted.png,1024,1448,587,499
10305,text,637,485,30,14,45_contrasted.png,1024,1448,667,499
10306,text,689,485,74,14,45_contrasted.png,1024,1448,763,499
10307,text,791,485,78,14,45_contrasted.png,1024,1448,869,499
10308,text,513,509,34,14,45_contrasted.png,1024,1448,547,523
10309,text,689,509,32,14,45_contrasted.png,1024,1448,721,523
10310,text,791,509,34,14,45_contrasted.png,1024,1448,825,523
10311,text,92,532,47,18,45_contrasted.png,1024,1448,139,550
10312,text,555,533,69,14,45_contrasted.png,1024,1448,624,547
10313,text,721,533,52,16,45_contrasted.png,1024,1448,773,549
10314,text,833,533,68,16,45_contrasted.png,1024,1448,901,549
10315,text,93,559,78,14,45_contrasted.png,1024,1448,171,573
10316,text,199,557,54,14,45_contrasted.png,1024,1448,253,571
10317,text,579,557,44,16,45_contrasted.png,1024,1448,623,573
10318,text,857,557,44,16,45_contrasted.png,1024,1448,901,573
10319,text,453,581,44,16,45_contrasted.png,1024,1448,497,597
10320,text,555,581,68,16,45_contrasted.png,1024,1448,623,597
10321,text,725,581,52,16,45_contrasted.png,1024,1448,777,597
10322,text,833,581,68,16,45_contrasted.png,1024,1448,901,597
10323,text,523,653,30,14,45_contrasted.png,1024,1448,553,667
10324,text,595,653,72,14,45_contrasted.png,1024,1448,667,667
10325,text,707,653,74,14,45_contrasted.png,1024,1448,781,667
10326,text,811,653,76,14,45_contrasted.png,1024,1448,887,667
10327,text,611,677,60,16,45_contrasted.png,1024,1448,671,693
10328,text,727,677,44,14,45_contrasted.png,1024,1448,771,691
10329,text,826,677,60,14,45_contrasted.png,1024,1448,886,691
10330,text,631,701,40,14,45_contrasted.png,1024,1448,671,715
10331,text,847,701,40,14,45_contrasted.png,1024,1448,887,715
10332,text,479,1131,44,16,45_contrasted.png,1024,1448,523,1147
10333,text,681,1131,72,16,45_contrasted.png,1024,1448,753,1147
10334,text,477,1155,60,16,45_contrasted.png,1024,1448,537,1171
10335,text,681,1155,74,16,45_contrasted.png,1024,1448,755,1171
10336,text,477,1177,86,18,45_contrasted.png,1024,1448,563,1195
10337,text,681,1179,88,16,45_contrasted.png,1024,1448,769,1195
10338,text,515,1203,72,16,45_contrasted.png,1024,1448,587,1219
10339,text,591,1205,30,12,45_contrasted.png,1024,1448,621,1217
10340,text,739,1203,52,16,45_contrasted.png,1024,1448,791,1219
10341,text,797,1205,28,14,45_contrasted.png,1024,1448,825,1219
10342,text,19,1385,178,14,45_contrasted.png,1024,1448,197,1399
10343,text,205,1383,36,16,45_contrasted.png,1024,1448,241,1399
10344,text,247,1383,202,16,45_contrasted.png,1024,1448,449,1399
10345,text,455,1383,120,16,45_contrasted.png,1024,1448,575,1399
10346,text,581,1385,106,14,45_contrasted.png,1024,1448,687,1399
10347,text,691,1385,40,14,45_contrasted.png,1024,1448,731,1399
10348,text,737,1383,122,18,45_contrasted.png,1024,1448,859,1401
10349,text,893,1385,98,16,45_contrasted.png,1024,1448,991,1401
10350,text,359,1405,94,14,45_contrasted.png,1024,1448,453,1419
10351,text,457,1405,52,14,45_contrasted.png,1024,1448,509,1419
10352,text,513,1405,30,14,45_contrasted.png,1024,1448,543,1419
10353,text,666,1404,124,15,45_contrasted.png,1024,1448,790,1419
10354,text,795,1407,76,14,45_contrasted.png,1024,1448,871,1421
10355,text,865,1387,24,14,45_contrasted.png,1024,1448,889,1401
10356,text,175,556,19,16,45_contrasted.png,1024,1448,194,572
10357,text,637,531,42,16,45_contrasted.png,1024,1448,679,547
10358,text,643,556,34,15,45_contrasted.png,1024,1448,677,571
10359,text,737,555,38,17,45_contrasted.png,1024,1448,775,572
10360,text,740,701,33,12,45_contrasted.png,1024,1448,773,713
10361,text,518,701,33,12,45_contrasted.png,1024,1448,551,713
10362,text,511,677,42,13,45_contrasted.png,1024,1448,553,690
10363,text,596,1404,65,14,45_contrasted.png,1024,1448,661,1418
10364,text,547,1404,44,14,45_contrasted.png,1024,1448,591,1418
10365,text,146,95,212,42,45_denoise.png,1024,1448,358,137
10366,text,526,216,258,24,45_denoise.png,1024,1448,784,240
10367,text,527,241,158,20,45_denoise.png,1024,1448,685,261
10368,text,527,289,84,20,45_denoise.png,1024,1448,611,309
10369,text,92,358,104,24,45_denoise.png,1024,1448,196,382
10370,text,204,357,102,24,45_denoise.png,1024,1448,306,381
10371,text,94,382,66,24,45_denoise.png,1024,1448,160,406
10372,text,204,382,92,24,45_denoise.png,1024,1448,296,406
10373,text,95,409,84,20,45_denoise.png,1024,1448,179,429
10374,text,205,409,92,20,45_denoise.png,1024,1448,297,429
10375,text,343,409,110,20,45_denoise.png,1024,1448,453,429
10376,text,493,409,84,20,45_denoise.png,1024,1448,577,429
10377,text,627,409,132,20,45_denoise.png,1024,1448,759,429
10378,text,781,409,94,20,45_denoise.png,1024,1448,875,429
10379,text,92,484,55,17,45_denoise.png,1024,1448,147,501
10380,text,515,485,72,14,45_denoise.png,1024,1448,587,499
10381,text,637,485,30,14,45_denoise.png,1024,1448,667,499
10382,text,689,485,74,14,45_denoise.png,1024,1448,763,499
10383,text,791,485,78,14,45_denoise.png,1024,1448,869,499
10384,text,513,509,34,14,45_denoise.png,1024,1448,547,523
10385,text,689,509,32,14,45_denoise.png,1024,1448,721,523
10386,text,791,509,34,14,45_denoise.png,1024,1448,825,523
10387,text,92,532,47,18,45_denoise.png,1024,1448,139,550
10388,text,555,533,69,14,45_denoise.png,1024,1448,624,547
10389,text,721,533,52,16,45_denoise.png,1024,1448,773,549
10390,text,833,533,68,16,45_denoise.png,1024,1448,901,549
10391,text,93,559,78,14,45_denoise.png,1024,1448,171,573
10392,text,199,557,54,14,45_denoise.png,1024,1448,253,571
10393,text,579,557,44,16,45_denoise.png,1024,1448,623,573
10394,text,857,557,44,16,45_denoise.png,1024,1448,901,573
10395,text,453,581,44,16,45_denoise.png,1024,1448,497,597
10396,text,555,581,68,16,45_denoise.png,1024,1448,623,597
10397,text,725,581,52,16,45_denoise.png,1024,1448,777,597
10398,text,833,581,68,16,45_denoise.png,1024,1448,901,597
10399,text,523,653,30,14,45_denoise.png,1024,1448,553,667
10400,text,595,653,72,14,45_denoise.png,1024,1448,667,667
10401,text,707,653,74,14,45_denoise.png,1024,1448,781,667
10402,text,811,653,76,14,45_denoise.png,1024,1448,887,667
10403,text,611,677,60,16,45_denoise.png,1024,1448,671,693
10404,text,727,677,44,14,45_denoise.png,1024,1448,771,691
10405,text,826,677,60,14,45_denoise.png,1024,1448,886,691
10406,text,631,701,40,14,45_denoise.png,1024,1448,671,715
10407,text,847,701,40,14,45_denoise.png,1024,1448,887,715
10408,text,479,1131,44,16,45_denoise.png,1024,1448,523,1147
10409,text,681,1131,72,16,45_denoise.png,1024,1448,753,1147
10410,text,477,1155,60,16,45_denoise.png,1024,1448,537,1171
10411,text,681,1155,74,16,45_denoise.png,1024,1448,755,1171
10412,text,477,1177,86,18,45_denoise.png,1024,1448,563,1195
10413,text,681,1179,88,16,45_denoise.png,1024,1448,769,1195
10414,text,515,1203,72,16,45_denoise.png,1024,1448,587,1219
10415,text,591,1205,30,12,45_denoise.png,1024,1448,621,1217
10416,text,739,1203,52,16,45_denoise.png,1024,1448,791,1219
10417,text,797,1205,28,14,45_denoise.png,1024,1448,825,1219
10418,text,19,1385,178,14,45_denoise.png,1024,1448,197,1399
10419,text,205,1383,36,16,45_denoise.png,1024,1448,241,1399
10420,text,247,1383,202,16,45_denoise.png,1024,1448,449,1399
10421,text,455,1383,120,16,45_denoise.png,1024,1448,575,1399
10422,text,581,1385,106,14,45_denoise.png,1024,1448,687,1399
10423,text,691,1385,40,14,45_denoise.png,1024,1448,731,1399
10424,text,737,1383,122,18,45_denoise.png,1024,1448,859,1401
10425,text,893,1385,98,16,45_denoise.png,1024,1448,991,1401
10426,text,359,1405,94,14,45_denoise.png,1024,1448,453,1419
10427,text,457,1405,52,14,45_denoise.png,1024,1448,509,1419
10428,text,513,1405,30,14,45_denoise.png,1024,1448,543,1419
10429,text,666,1404,124,15,45_denoise.png,1024,1448,790,1419
10430,text,795,1407,76,14,45_denoise.png,1024,1448,871,1421
10431,text,865,1387,24,14,45_denoise.png,1024,1448,889,1401
10432,text,175,556,19,16,45_denoise.png,1024,1448,194,572
10433,text,637,531,42,16,45_denoise.png,1024,1448,679,547
10434,text,643,556,34,15,45_denoise.png,1024,1448,677,571
10435,text,737,555,38,17,45_denoise.png,1024,1448,775,572
10436,text,740,701,33,12,45_denoise.png,1024,1448,773,713
10437,text,518,701,33,12,45_denoise.png,1024,1448,551,713
10438,text,511,677,42,13,45_denoise.png,1024,1448,553,690
10439,text,596,1404,65,14,45_denoise.png,1024,1448,661,1418
10440,text,547,1404,44,14,45_denoise.png,1024,1448,591,1418
10441,text,146,95,212,42,45_median.png,1024,1448,358,137
10442,text,526,216,258,24,45_median.png,1024,1448,784,240
10443,text,527,241,158,20,45_median.png,1024,1448,685,261
10444,text,527,289,84,20,45_median.png,1024,1448,611,309
10445,text,92,358,104,24,45_median.png,1024,1448,196,382
10446,text,204,357,102,24,45_median.png,1024,1448,306,381
10447,text,94,382,66,24,45_median.png,1024,1448,160,406
10448,text,204,382,92,24,45_median.png,1024,1448,296,406
10449,text,95,409,84,20,45_median.png,1024,1448,179,429
10450,text,205,409,92,20,45_median.png,1024,1448,297,429
10451,text,343,409,110,20,45_median.png,1024,1448,453,429
10452,text,493,409,84,20,45_median.png,1024,1448,577,429
10453,text,627,409,132,20,45_median.png,1024,1448,759,429
10454,text,781,409,94,20,45_median.png,1024,1448,875,429
10455,text,92,484,55,17,45_median.png,1024,1448,147,501
10456,text,515,485,72,14,45_median.png,1024,1448,587,499
10457,text,637,485,30,14,45_median.png,1024,1448,667,499
10458,text,689,485,74,14,45_median.png,1024,1448,763,499
10459,text,791,485,78,14,45_median.png,1024,1448,869,499
10460,text,513,509,34,14,45_median.png,1024,1448,547,523
10461,text,689,509,32,14,45_median.png,1024,1448,721,523
10462,text,791,509,34,14,45_median.png,1024,1448,825,523
10463,text,92,532,47,18,45_median.png,1024,1448,139,550
10464,text,555,533,69,14,45_median.png,1024,1448,624,547
10465,text,721,533,52,16,45_median.png,1024,1448,773,549
10466,text,833,533,68,16,45_median.png,1024,1448,901,549
10467,text,93,559,78,14,45_median.png,1024,1448,171,573
10468,text,199,557,54,14,45_median.png,1024,1448,253,571
10469,text,579,557,44,16,45_median.png,1024,1448,623,573
10470,text,857,557,44,16,45_median.png,1024,1448,901,573
10471,text,453,581,44,16,45_median.png,1024,1448,497,597
10472,text,555,581,68,16,45_median.png,1024,1448,623,597
10473,text,725,581,52,16,45_median.png,1024,1448,777,597
10474,text,833,581,68,16,45_median.png,1024,1448,901,597
10475,text,523,653,30,14,45_median.png,1024,1448,553,667
10476,text,595,653,72,14,45_median.png,1024,1448,667,667
10477,text,707,653,74,14,45_median.png,1024,1448,781,667
10478,text,811,653,76,14,45_median.png,1024,1448,887,667
10479,text,611,677,60,16,45_median.png,1024,1448,671,693
10480,text,727,677,44,14,45_median.png,1024,1448,771,691
10481,text,826,677,60,14,45_median.png,1024,1448,886,691
10482,text,631,701,40,14,45_median.png,1024,1448,671,715
10483,text,847,701,40,14,45_median.png,1024,1448,887,715
10484,text,479,1131,44,16,45_median.png,1024,1448,523,1147
10485,text,681,1131,72,16,45_median.png,1024,1448,753,1147
10486,text,477,1155,60,16,45_median.png,1024,1448,537,1171
10487,text,681,1155,74,16,45_median.png,1024,1448,755,1171
10488,text,477,1177,86,18,45_median.png,1024,1448,563,1195
10489,text,681,1179,88,16,45_median.png,1024,1448,769,1195
10490,text,515,1203,72,16,45_median.png,1024,1448,587,1219
10491,text,591,1205,30,12,45_median.png,1024,1448,621,1217
10492,text,739,1203,52,16,45_median.png,1024,1448,791,1219
10493,text,797,1205,28,14,45_median.png,1024,1448,825,1219
10494,text,19,1385,178,14,45_median.png,1024,1448,197,1399
10495,text,205,1383,36,16,45_median.png,1024,1448,241,1399
10496,text,247,1383,202,16,45_median.png,1024,1448,449,1399
10497,text,455,1383,120,16,45_median.png,1024,1448,575,1399
10498,text,581,1385,106,14,45_median.png,1024,1448,687,1399
10499,text,691,1385,40,14,45_median.png,1024,1448,731,1399
10500,text,737,1383,122,18,45_median.png,1024,1448,859,1401
10501,text,893,1385,98,16,45_median.png,1024,1448,991,1401
10502,text,359,1405,94,14,45_median.png,1024,1448,453,1419
10503,text,457,1405,52,14,45_median.png,1024,1448,509,1419
10504,text,513,1405,30,14,45_median.png,1024,1448,543,1419
10505,text,666,1404,124,15,45_median.png,1024,1448,790,1419
10506,text,795,1407,76,14,45_median.png,1024,1448,871,1421
10507,text,865,1387,24,14,45_median.png,1024,1448,889,1401
10508,text,175,556,19,16,45_median.png,1024,1448,194,572
10509,text,637,531,42,16,45_median.png,1024,1448,679,547
10510,text,643,556,34,15,45_median.png,1024,1448,677,571
10511,text,737,555,38,17,45_median.png,1024,1448,775,572
10512,text,740,701,33,12,45_median.png,1024,1448,773,713
10513,text,518,701,33,12,45_median.png,1024,1448,551,713
10514,text,511,677,42,13,45_median.png,1024,1448,553,690
10515,text,596,1404,65,14,45_median.png,1024,1448,661,1418
10516,text,547,1404,44,14,45_median.png,1024,1448,591,1418
10517,text,494,68,320,30,46.png,1024,1430,814,98
10518,text,531,213,160,20,46.png,1024,1430,691,233
10519,text,529,253,162,18,46.png,1024,1430,691,271
10520,text,533,293,106,18,46.png,1024,1430,639,311
10521,text,27,335,156,42,46.png,1024,1430,183,377
10522,text,53,439,74,18,46.png,1024,1430,127,457
10523,text,195,439,46,18,46.png,1024,1430,241,457
10524,text,354,439,96,18,46.png,1024,1430,450,457
10525,text,571,441,88,16,46.png,1024,1430,659,457
10526,text,47,471,78,20,46.png,1024,1430,125,491
10527,text,175,473,64,18,46.png,1024,1430,239,491
10528,text,583,475,66,18,46.png,1024,1430,649,493
10529,text,57,541,78,16,46.png,1024,1430,135,557
10530,text,299,541,90,18,46.png,1024,1430,389,559
10531,text,579,541,28,16,46.png,1024,1430,607,557
10532,text,639,541,80,16,46.png,1024,1430,719,557
10533,text,739,541,56,16,46.png,1024,1430,795,557
10534,text,813,541,86,16,46.png,1024,1430,899,557
10535,text,29,573,62,18,46.png,1024,1430,91,591
10536,text,149,571,364,20,46.png,1024,1430,513,591
10537,text,567,573,34,18,46.png,1024,1430,601,591
10538,text,671,573,50,18,46.png,1024,1430,721,591
10539,text,853,573,50,18,46.png,1024,1430,903,591
10540,text,149,589,138,20,46.png,1024,1430,287,609
10541,text,287,589,110,20,46.png,1024,1430,397,609
10542,text,149,607,294,20,46.png,1024,1430,443,627
10543,text,455,607,68,20,46.png,1024,1430,523,627
10544,text,150,626,100,16,46.png,1024,1430,250,642
10545,text,253,627,60,16,46.png,1024,1430,313,643
10546,text,27,645,64,16,46.png,1024,1430,91,661
10547,text,149,642,364,19,46.png,1024,1430,513,661
10548,text,567,643,34,18,46.png,1024,1430,601,661
10549,text,671,645,50,16,46.png,1024,1430,721,661
10550,text,851,643,52,18,46.png,1024,1430,903,661
10551,text,149,659,136,20,46.png,1024,1430,285,679
10552,text,286,661,109,18,46.png,1024,1430,395,679
10553,text,149,677,374,20,46.png,1024,1430,523,697
10554,text,146,694,102,20,46.png,1024,1430,248,714
10555,text,250,695,63,20,46.png,1024,1430,313,715
10556,text,151,1069,82,18,46.png,1024,1430,233,1087
10557,text,849,1071,50,18,46.png,1024,1430,899,1089
10558,text,153,1097,86,18,46.png,1024,1430,239,1115
10559,text,851,1099,50,18,46.png,1024,1430,901,1117
10560,text,151,1129,88,20,46.png,1024,1430,239,1149
10561,text,851,1131,50,16,46.png,1024,1430,901,1147
10562,text,39,1159,384,21,46.png,1024,1430,423,1180
10563,text,39,1180,320,21,46.png,1024,1430,359,1201
10564,text,105,1227,190,20,46.png,1024,1430,295,1247
10565,text,179,1333,32,18,46.png,1024,1430,211,1351
10566,text,221,1333,124,18,46.png,1024,1430,345,1351
10567,text,355,1333,24,16,46.png,1024,1430,379,1349
10568,text,387,1331,66,16,46.png,1024,1430,453,1347
10569,text,463,1331,56,16,46.png,1024,1430,519,1347
10570,text,527,1329,74,18,46.png,1024,1430,601,1347
10571,text,608,1322,88,24,46.png,1024,1430,696,1346
10572,text,761,1323,66,18,46.png,1024,1430,827,1341
10573,text,335,1347,280,21,46.png,1024,1430,615,1368
10574,text,625,1347,50,16,46.png,1024,1430,675,1363
10575,text,124,1366,188,24,46.png,1024,1430,312,1390
10576,text,325,1365,104,20,46.png,1024,1430,429,1385
10577,text,439,1363,190,20,46.png,1024,1430,629,1383
10578,text,639,1363,50,16,46.png,1024,1430,689,1379
10579,text,698,1359,186,25,46.png,1024,1430,884,1384
10580,text,929,571,14,18,46.png,1024,1430,943,589
10581,text,929,640,14,21,46.png,1024,1430,943,661
10582,text,920,536,15,17,46.png,1024,1430,935,553
10583,text,709,1324,46,18,46.png,1024,1430,755,1342
10584,text,494,68,320,30,46_contrasted.png,1024,1430,814,98
10585,text,531,213,160,20,46_contrasted.png,1024,1430,691,233
10586,text,529,253,162,18,46_contrasted.png,1024,1430,691,271
10587,text,533,293,106,18,46_contrasted.png,1024,1430,639,311
10588,text,27,335,156,42,46_contrasted.png,1024,1430,183,377
10589,text,53,439,74,18,46_contrasted.png,1024,1430,127,457
10590,text,195,439,46,18,46_contrasted.png,1024,1430,241,457
10591,text,354,439,96,18,46_contrasted.png,1024,1430,450,457
10592,text,571,441,88,16,46_contrasted.png,1024,1430,659,457
10593,text,47,471,78,20,46_contrasted.png,1024,1430,125,491
10594,text,175,473,64,18,46_contrasted.png,1024,1430,239,491
10595,text,583,475,66,18,46_contrasted.png,1024,1430,649,493
10596,text,57,541,78,16,46_contrasted.png,1024,1430,135,557
10597,text,299,541,90,18,46_contrasted.png,1024,1430,389,559
10598,text,579,541,28,16,46_contrasted.png,1024,1430,607,557
10599,text,639,541,80,16,46_contrasted.png,1024,1430,719,557
10600,text,739,541,56,16,46_contrasted.png,1024,1430,795,557
10601,text,813,541,86,16,46_contrasted.png,1024,1430,899,557
10602,text,29,573,62,18,46_contrasted.png,1024,1430,91,591
10603,text,149,571,364,20,46_contrasted.png,1024,1430,513,591
10604,text,567,573,34,18,46_contrasted.png,1024,1430,601,591
10605,text,671,573,50,18,46_contrasted.png,1024,1430,721,591
10606,text,853,573,50,18,46_contrasted.png,1024,1430,903,591
10607,text,149,589,138,20,46_contrasted.png,1024,1430,287,609
10608,text,287,589,110,20,46_contrasted.png,1024,1430,397,609
10609,text,149,607,294,20,46_contrasted.png,1024,1430,443,627
10610,text,455,607,68,20,46_contrasted.png,1024,1430,523,627
10611,text,150,626,100,16,46_contrasted.png,1024,1430,250,642
10612,text,253,627,60,16,46_contrasted.png,1024,1430,313,643
10613,text,27,645,64,16,46_contrasted.png,1024,1430,91,661
10614,text,149,642,364,19,46_contrasted.png,1024,1430,513,661
10615,text,567,643,34,18,46_contrasted.png,1024,1430,601,661
10616,text,671,645,50,16,46_contrasted.png,1024,1430,721,661
10617,text,851,643,52,18,46_contrasted.png,1024,1430,903,661
10618,text,149,659,136,20,46_contrasted.png,1024,1430,285,679
10619,text,286,661,109,18,46_contrasted.png,1024,1430,395,679
10620,text,149,677,374,20,46_contrasted.png,1024,1430,523,697
10621,text,146,694,102,20,46_contrasted.png,1024,1430,248,714
10622,text,250,695,63,20,46_contrasted.png,1024,1430,313,715
10623,text,151,1069,82,18,46_contrasted.png,1024,1430,233,1087
10624,text,849,1071,50,18,46_contrasted.png,1024,1430,899,1089
10625,text,153,1097,86,18,46_contrasted.png,1024,1430,239,1115
10626,text,851,1099,50,18,46_contrasted.png,1024,1430,901,1117
10627,text,151,1129,88,20,46_contrasted.png,1024,1430,239,1149
10628,text,851,1131,50,16,46_contrasted.png,1024,1430,901,1147
10629,text,39,1159,384,21,46_contrasted.png,1024,1430,423,1180
10630,text,39,1180,320,21,46_contrasted.png,1024,1430,359,1201
10631,text,105,1227,190,20,46_contrasted.png,1024,1430,295,1247
10632,text,179,1333,32,18,46_contrasted.png,1024,1430,211,1351
10633,text,221,1333,124,18,46_contrasted.png,1024,1430,345,1351
10634,text,355,1333,24,16,46_contrasted.png,1024,1430,379,1349
10635,text,387,1331,66,16,46_contrasted.png,1024,1430,453,1347
10636,text,463,1331,56,16,46_contrasted.png,1024,1430,519,1347
10637,text,527,1329,74,18,46_contrasted.png,1024,1430,601,1347
10638,text,608,1322,88,24,46_contrasted.png,1024,1430,696,1346
10639,text,761,1323,66,18,46_contrasted.png,1024,1430,827,1341
10640,text,335,1347,280,21,46_contrasted.png,1024,1430,615,1368
10641,text,625,1347,50,16,46_contrasted.png,1024,1430,675,1363
10642,text,124,1366,188,24,46_contrasted.png,1024,1430,312,1390
10643,text,325,1365,104,20,46_contrasted.png,1024,1430,429,1385
10644,text,439,1363,190,20,46_contrasted.png,1024,1430,629,1383
10645,text,639,1363,50,16,46_contrasted.png,1024,1430,689,1379
10646,text,698,1359,186,25,46_contrasted.png,1024,1430,884,1384
10647,text,929,571,14,18,46_contrasted.png,1024,1430,943,589
10648,text,929,640,14,21,46_contrasted.png,1024,1430,943,661
10649,text,920,536,15,17,46_contrasted.png,1024,1430,935,553
10650,text,709,1324,46,18,46_contrasted.png,1024,1430,755,1342
10651,text,494,68,320,30,46_denoise.png,1024,1430,814,98
10652,text,531,213,160,20,46_denoise.png,1024,1430,691,233
10653,text,529,253,162,18,46_denoise.png,1024,1430,691,271
10654,text,533,293,106,18,46_denoise.png,1024,1430,639,311
10655,text,27,335,156,42,46_denoise.png,1024,1430,183,377
10656,text,53,439,74,18,46_denoise.png,1024,1430,127,457
10657,text,195,439,46,18,46_denoise.png,1024,1430,241,457
10658,text,354,439,96,18,46_denoise.png,1024,1430,450,457
10659,text,571,441,88,16,46_denoise.png,1024,1430,659,457
10660,text,47,471,78,20,46_denoise.png,1024,1430,125,491
10661,text,175,473,64,18,46_denoise.png,1024,1430,239,491
10662,text,583,475,66,18,46_denoise.png,1024,1430,649,493
10663,text,57,541,78,16,46_denoise.png,1024,1430,135,557
10664,text,299,541,90,18,46_denoise.png,1024,1430,389,559
10665,text,579,541,28,16,46_denoise.png,1024,1430,607,557
10666,text,639,541,80,16,46_denoise.png,1024,1430,719,557
10667,text,739,541,56,16,46_denoise.png,1024,1430,795,557
10668,text,813,541,86,16,46_denoise.png,1024,1430,899,557
10669,text,29,573,62,18,46_denoise.png,1024,1430,91,591
10670,text,149,571,364,20,46_denoise.png,1024,1430,513,591
10671,text,567,573,34,18,46_denoise.png,1024,1430,601,591
10672,text,671,573,50,18,46_denoise.png,1024,1430,721,591
10673,text,853,573,50,18,46_denoise.png,1024,1430,903,591
10674,text,149,589,138,20,46_denoise.png,1024,1430,287,609
10675,text,287,589,110,20,46_denoise.png,1024,1430,397,609
10676,text,149,607,294,20,46_denoise.png,1024,1430,443,627
10677,text,455,607,68,20,46_denoise.png,1024,1430,523,627
10678,text,150,626,100,16,46_denoise.png,1024,1430,250,642
10679,text,253,627,60,16,46_denoise.png,1024,1430,313,643
10680,text,27,645,64,16,46_denoise.png,1024,1430,91,661
10681,text,149,642,364,19,46_denoise.png,1024,1430,513,661
10682,text,567,643,34,18,46_denoise.png,1024,1430,601,661
10683,text,671,645,50,16,46_denoise.png,1024,1430,721,661
10684,text,851,643,52,18,46_denoise.png,1024,1430,903,661
10685,text,149,659,136,20,46_denoise.png,1024,1430,285,679
10686,text,286,661,109,18,46_denoise.png,1024,1430,395,679
10687,text,149,677,374,20,46_denoise.png,1024,1430,523,697
10688,text,146,694,102,20,46_denoise.png,1024,1430,248,714
10689,text,250,695,63,20,46_denoise.png,1024,1430,313,715
10690,text,151,1069,82,18,46_denoise.png,1024,1430,233,1087
10691,text,849,1071,50,18,46_denoise.png,1024,1430,899,1089
10692,text,153,1097,86,18,46_denoise.png,1024,1430,239,1115
10693,text,851,1099,50,18,46_denoise.png,1024,1430,901,1117
10694,text,151,1129,88,20,46_denoise.png,1024,1430,239,1149
10695,text,851,1131,50,16,46_denoise.png,1024,1430,901,1147
10696,text,39,1159,384,21,46_denoise.png,1024,1430,423,1180
10697,text,39,1180,320,21,46_denoise.png,1024,1430,359,1201
10698,text,105,1227,190,20,46_denoise.png,1024,1430,295,1247
10699,text,179,1333,32,18,46_denoise.png,1024,1430,211,1351
10700,text,221,1333,124,18,46_denoise.png,1024,1430,345,1351
10701,text,355,1333,24,16,46_denoise.png,1024,1430,379,1349
10702,text,387,1331,66,16,46_denoise.png,1024,1430,453,1347
10703,text,463,1331,56,16,46_denoise.png,1024,1430,519,1347
10704,text,527,1329,74,18,46_denoise.png,1024,1430,601,1347
10705,text,608,1322,88,24,46_denoise.png,1024,1430,696,1346
10706,text,761,1323,66,18,46_denoise.png,1024,1430,827,1341
10707,text,335,1347,280,21,46_denoise.png,1024,1430,615,1368
10708,text,625,1347,50,16,46_denoise.png,1024,1430,675,1363
10709,text,124,1366,188,24,46_denoise.png,1024,1430,312,1390
10710,text,325,1365,104,20,46_denoise.png,1024,1430,429,1385
10711,text,439,1363,190,20,46_denoise.png,1024,1430,629,1383
10712,text,639,1363,50,16,46_denoise.png,1024,1430,689,1379
10713,text,698,1359,186,25,46_denoise.png,1024,1430,884,1384
10714,text,929,571,14,18,46_denoise.png,1024,1430,943,589
10715,text,929,640,14,21,46_denoise.png,1024,1430,943,661
10716,text,920,536,15,17,46_denoise.png,1024,1430,935,553
10717,text,709,1324,46,18,46_denoise.png,1024,1430,755,1342
10718,text,494,68,320,30,46_median.png,1024,1430,814,98
10719,text,531,213,160,20,46_median.png,1024,1430,691,233
10720,text,529,253,162,18,46_median.png,1024,1430,691,271
10721,text,533,293,106,18,46_median.png,1024,1430,639,311
10722,text,27,335,156,42,46_median.png,1024,1430,183,377
10723,text,53,439,74,18,46_median.png,1024,1430,127,457
10724,text,195,439,46,18,46_median.png,1024,1430,241,457
10725,text,354,439,96,18,46_median.png,1024,1430,450,457
10726,text,571,441,88,16,46_median.png,1024,1430,659,457
10727,text,47,471,78,20,46_median.png,1024,1430,125,491
10728,text,175,473,64,18,46_median.png,1024,1430,239,491
10729,text,583,475,66,18,46_median.png,1024,1430,649,493
10730,text,57,541,78,16,46_median.png,1024,1430,135,557
10731,text,299,541,90,18,46_median.png,1024,1430,389,559
10732,text,579,541,28,16,46_median.png,1024,1430,607,557
10733,text,639,541,80,16,46_median.png,1024,1430,719,557
10734,text,739,541,56,16,46_median.png,1024,1430,795,557
10735,text,813,541,86,16,46_median.png,1024,1430,899,557
10736,text,29,573,62,18,46_median.png,1024,1430,91,591
10737,text,149,571,364,20,46_median.png,1024,1430,513,591
10738,text,567,573,34,18,46_median.png,1024,1430,601,591
10739,text,671,573,50,18,46_median.png,1024,1430,721,591
10740,text,853,573,50,18,46_median.png,1024,1430,903,591
10741,text,149,589,138,20,46_median.png,1024,1430,287,609
10742,text,287,589,110,20,46_median.png,1024,1430,397,609
10743,text,149,607,294,20,46_median.png,1024,1430,443,627
10744,text,455,607,68,20,46_median.png,1024,1430,523,627
10745,text,150,626,100,16,46_median.png,1024,1430,250,642
10746,text,253,627,60,16,46_median.png,1024,1430,313,643
10747,text,27,645,64,16,46_median.png,1024,1430,91,661
10748,text,149,642,364,19,46_median.png,1024,1430,513,661
10749,text,567,643,34,18,46_median.png,1024,1430,601,661
10750,text,671,645,50,16,46_median.png,1024,1430,721,661
10751,text,851,643,52,18,46_median.png,1024,1430,903,661
10752,text,149,659,136,20,46_median.png,1024,1430,285,679
10753,text,286,661,109,18,46_median.png,1024,1430,395,679
10754,text,149,677,374,20,46_median.png,1024,1430,523,697
10755,text,146,694,102,20,46_median.png,1024,1430,248,714
10756,text,250,695,63,20,46_median.png,1024,1430,313,715
10757,text,151,1069,82,18,46_median.png,1024,1430,233,1087
10758,text,849,1071,50,18,46_median.png,1024,1430,899,1089
10759,text,153,1097,86,18,46_median.png,1024,1430,239,1115
10760,text,851,1099,50,18,46_median.png,1024,1430,901,1117
10761,text,151,1129,88,20,46_median.png,1024,1430,239,1149
10762,text,851,1131,50,16,46_median.png,1024,1430,901,1147
10763,text,39,1159,384,21,46_median.png,1024,1430,423,1180
10764,text,39,1180,320,21,46_median.png,1024,1430,359,1201
10765,text,105,1227,190,20,46_median.png,1024,1430,295,1247
10766,text,179,1333,32,18,46_median.png,1024,1430,211,1351
10767,text,221,1333,124,18,46_median.png,1024,1430,345,1351
10768,text,355,1333,24,16,46_median.png,1024,1430,379,1349
10769,text,387,1331,66,16,46_median.png,1024,1430,453,1347
10770,text,463,1331,56,16,46_median.png,1024,1430,519,1347
10771,text,527,1329,74,18,46_median.png,1024,1430,601,1347
10772,text,608,1322,88,24,46_median.png,1024,1430,696,1346
10773,text,761,1323,66,18,46_median.png,1024,1430,827,1341
10774,text,335,1347,280,21,46_median.png,1024,1430,615,1368
10775,text,625,1347,50,16,46_median.png,1024,1430,675,1363
10776,text,124,1366,188,24,46_median.png,1024,1430,312,1390
10777,text,325,1365,104,20,46_median.png,1024,1430,429,1385
10778,text,439,1363,190,20,46_median.png,1024,1430,629,1383
10779,text,639,1363,50,16,46_median.png,1024,1430,689,1379
10780,text,698,1359,186,25,46_median.png,1024,1430,884,1384
10781,text,929,571,14,18,46_median.png,1024,1430,943,589
10782,text,929,640,14,21,46_median.png,1024,1430,943,661
10783,text,920,536,15,17,46_median.png,1024,1430,935,553
10784,text,709,1324,46,18,46_median.png,1024,1430,755,1342
10785,text,122,52,118,24,47.png,1024,1448,240,76
10786,text,630,58,192,24,47.png,1024,1448,822,82
10787,text,834,56,104,24,47.png,1024,1448,938,80
10788,text,74,75,388,27,47.png,1024,1448,462,102
10789,text,75,97,140,20,47.png,1024,1448,215,117
10790,text,75,115,64,20,47.png,1024,1448,139,135
10791,text,643,115,52,20,47.png,1024,1448,695,135
10792,text,757,115,50,20,47.png,1024,1448,807,135
10793,text,75,133,32,20,47.png,1024,1448,107,153
10794,text,115,133,134,20,47.png,1024,1448,249,153
10795,text,259,135,32,18,47.png,1024,1448,291,153
10796,text,77,153,206,20,47.png,1024,1448,283,173
10797,text,291,153,22,18,47.png,1024,1448,313,171
10798,text,321,151,76,20,47.png,1024,1448,397,171
10799,text,655,145,28,18,47.png,1024,1448,683,163
10800,text,736,142,88,20,47.png,1024,1448,824,162
10801,text,73,171,188,20,47.png,1024,1448,261,191
10802,text,269,171,140,20,47.png,1024,1448,409,191
10803,text,72,186,166,26,47.png,1024,1448,238,212
10804,text,626,222,121,24,47.png,1024,1448,747,246
10805,text,626,245,265,26,47.png,1024,1448,891,271
10806,text,627,267,144,20,47.png,1024,1448,771,287
10807,text,625,285,178,20,47.png,1024,1448,803,305
10808,text,627,323,64,20,47.png,1024,1448,691,343
10809,text,114,396,188,26,47.png,1024,1448,302,422
10810,text,404,395,162,26,47.png,1024,1448,566,421
10811,text,691,399,198,18,47.png,1024,1448,889,417
10812,text,159,420,101,24,47.png,1024,1448,260,444
10813,text,441,419,88,20,47.png,1024,1448,529,439
10814,text,725,421,130,18,47.png,1024,1448,855,439
10815,text,85,491,106,20,47.png,1024,1448,191,511
10816,text,313,491,116,18,47.png,1024,1448,429,509
10817,text,543,489,86,20,47.png,1024,1448,629,509
10818,text,665,489,62,20,47.png,1024,1448,727,509
10819,text,765,489,122,20,47.png,1024,1448,887,509
10820,text,903,489,34,18,47.png,1024,1448,937,507
10821,text,70,524,88,24,47.png,1024,1448,158,548
10822,text,211,524,229,25,47.png,1024,1448,440,549
10823,text,678,520,68,26,47.png,1024,1448,746,546
10824,text,819,523,64,20,47.png,1024,1448,883,543
10825,text,67,1181,104,14,47.png,1024,1448,171,1195
10826,text,177,1181,48,14,47.png,1024,1448,225,1195
10827,text,225,1177,468,20,47.png,1024,1448,693,1197
10828,text,697,1179,196,14,47.png,1024,1448,893,1193
10829,text,67,1199,150,16,47.png,1024,1448,217,1215
10830,text,227,1197,386,16,47.png,1024,1448,613,1213
10831,text,109,1225,68,16,47.png,1024,1448,177,1241
10832,text,201,1223,54,16,47.png,1024,1448,255,1239
10833,text,289,1223,52,16,47.png,1024,1448,341,1239
10834,text,357,1223,46,16,47.png,1024,1448,403,1239
10835,text,427,1223,40,16,47.png,1024,1448,467,1239
10836,text,529,1223,56,16,47.png,1024,1448,585,1239
10837,text,785,1223,32,14,47.png,1024,1448,817,1237
10838,text,129,1243,52,16,47.png,1024,1448,181,1259
10839,text,303,1243,44,16,47.png,1024,1448,347,1259
10840,text,367,1243,36,14,47.png,1024,1448,403,1257
10841,text,681,1247,60,14,47.png,1024,1448,741,1261
10842,text,781,1245,52,16,47.png,1024,1448,833,1261
10843,text,495,1271,24,12,47.png,1024,1448,519,1283
10844,text,559,1267,52,16,47.png,1024,1448,611,1283
10845,text,683,1271,54,12,47.png,1024,1448,737,1283
10846,text,803,1269,30,16,47.png,1024,1448,833,1285
10847,text,495,1295,38,12,47.png,1024,1448,533,1307
10848,text,565,1289,44,16,47.png,1024,1448,609,1305
10849,text,676,1293,69,14,47.png,1024,1448,745,1307
10850,text,781,1291,52,16,47.png,1024,1448,833,1307
10851,text,75,57,47,23,47.png,1024,1448,122,80
10852,text,572,524,19,22,47.png,1024,1448,591,546
10853,text,907,522,18,25,47.png,1024,1448,925,547
10854,text,70,1243,11,15,47.png,1024,1448,81,1258
10855,text,122,52,118,24,47_contrasted.png,1024,1448,240,76
10856,text,630,58,192,24,47_contrasted.png,1024,1448,822,82
10857,text,834,56,104,24,47_contrasted.png,1024,1448,938,80
10858,text,74,75,388,27,47_contrasted.png,1024,1448,462,102
10859,text,75,97,140,20,47_contrasted.png,1024,1448,215,117
10860,text,75,115,64,20,47_contrasted.png,1024,1448,139,135
10861,text,643,115,52,20,47_contrasted.png,1024,1448,695,135
10862,text,757,115,50,20,47_contrasted.png,1024,1448,807,135
10863,text,75,133,32,20,47_contrasted.png,1024,1448,107,153
10864,text,115,133,134,20,47_contrasted.png,1024,1448,249,153
10865,text,259,135,32,18,47_contrasted.png,1024,1448,291,153
10866,text,77,153,206,20,47_contrasted.png,1024,1448,283,173
10867,text,291,153,22,18,47_contrasted.png,1024,1448,313,171
10868,text,321,151,76,20,47_contrasted.png,1024,1448,397,171
10869,text,655,145,28,18,47_contrasted.png,1024,1448,683,163
10870,text,736,142,88,20,47_contrasted.png,1024,1448,824,162
10871,text,73,171,188,20,47_contrasted.png,1024,1448,261,191
10872,text,269,171,140,20,47_contrasted.png,1024,1448,409,191
10873,text,72,186,166,26,47_contrasted.png,1024,1448,238,212
10874,text,626,222,121,24,47_contrasted.png,1024,1448,747,246
10875,text,626,245,265,26,47_contrasted.png,1024,1448,891,271
10876,text,627,267,144,20,47_contrasted.png,1024,1448,771,287
10877,text,625,285,178,20,47_contrasted.png,1024,1448,803,305
10878,text,627,323,64,20,47_contrasted.png,1024,1448,691,343
10879,text,114,396,188,26,47_contrasted.png,1024,1448,302,422
10880,text,404,395,162,26,47_contrasted.png,1024,1448,566,421
10881,text,691,399,198,18,47_contrasted.png,1024,1448,889,417
10882,text,159,420,101,24,47_contrasted.png,1024,1448,260,444
10883,text,441,419,88,20,47_contrasted.png,1024,1448,529,439
10884,text,725,421,130,18,47_contrasted.png,1024,1448,855,439
10885,text,85,491,106,20,47_contrasted.png,1024,1448,191,511
10886,text,313,491,116,18,47_contrasted.png,1024,1448,429,509
10887,text,543,489,86,20,47_contrasted.png,1024,1448,629,509
10888,text,665,489,62,20,47_contrasted.png,1024,1448,727,509
10889,text,765,489,122,20,47_contrasted.png,1024,1448,887,509
10890,text,903,489,34,18,47_contrasted.png,1024,1448,937,507
10891,text,70,524,88,24,47_contrasted.png,1024,1448,158,548
10892,text,211,524,229,25,47_contrasted.png,1024,1448,440,549
10893,text,678,520,68,26,47_contrasted.png,1024,1448,746,546
10894,text,819,523,64,20,47_contrasted.png,1024,1448,883,543
10895,text,67,1181,104,14,47_contrasted.png,1024,1448,171,1195
10896,text,177,1181,48,14,47_contrasted.png,1024,1448,225,1195
10897,text,225,1177,468,20,47_contrasted.png,1024,1448,693,1197
10898,text,697,1179,196,14,47_contrasted.png,1024,1448,893,1193
10899,text,67,1199,150,16,47_contrasted.png,1024,1448,217,1215
10900,text,227,1197,386,16,47_contrasted.png,1024,1448,613,1213
10901,text,109,1225,68,16,47_contrasted.png,1024,1448,177,1241
10902,text,201,1223,54,16,47_contrasted.png,1024,1448,255,1239
10903,text,289,1223,52,16,47_contrasted.png,1024,1448,341,1239
10904,text,357,1223,46,16,47_contrasted.png,1024,1448,403,1239
10905,text,427,1223,40,16,47_contrasted.png,1024,1448,467,1239
10906,text,529,1223,56,16,47_contrasted.png,1024,1448,585,1239
10907,text,785,1223,32,14,47_contrasted.png,1024,1448,817,1237
10908,text,129,1243,52,16,47_contrasted.png,1024,1448,181,1259
10909,text,303,1243,44,16,47_contrasted.png,1024,1448,347,1259
10910,text,367,1243,36,14,47_contrasted.png,1024,1448,403,1257
10911,text,681,1247,60,14,47_contrasted.png,1024,1448,741,1261
10912,text,781,1245,52,16,47_contrasted.png,1024,1448,833,1261
10913,text,495,1271,24,12,47_contrasted.png,1024,1448,519,1283
10914,text,559,1267,52,16,47_contrasted.png,1024,1448,611,1283
10915,text,683,1271,54,12,47_contrasted.png,1024,1448,737,1283
10916,text,803,1269,30,16,47_contrasted.png,1024,1448,833,1285
10917,text,495,1295,38,12,47_contrasted.png,1024,1448,533,1307
10918,text,565,1289,44,16,47_contrasted.png,1024,1448,609,1305
10919,text,676,1293,69,14,47_contrasted.png,1024,1448,745,1307
10920,text,781,1291,52,16,47_contrasted.png,1024,1448,833,1307
10921,text,75,57,47,23,47_contrasted.png,1024,1448,122,80
10922,text,572,524,19,22,47_contrasted.png,1024,1448,591,546
10923,text,907,522,18,25,47_contrasted.png,1024,1448,925,547
10924,text,70,1243,11,15,47_contrasted.png,1024,1448,81,1258
10925,text,122,52,118,24,47_denoise.png,1024,1448,240,76
10926,text,630,58,192,24,47_denoise.png,1024,1448,822,82
10927,text,834,56,104,24,47_denoise.png,1024,1448,938,80
10928,text,74,75,388,27,47_denoise.png,1024,1448,462,102
10929,text,75,97,140,20,47_denoise.png,1024,1448,215,117
10930,text,75,115,64,20,47_denoise.png,1024,1448,139,135
10931,text,643,115,52,20,47_denoise.png,1024,1448,695,135
10932,text,757,115,50,20,47_denoise.png,1024,1448,807,135
10933,text,75,133,32,20,47_denoise.png,1024,1448,107,153
10934,text,115,133,134,20,47_denoise.png,1024,1448,249,153
10935,text,259,135,32,18,47_denoise.png,1024,1448,291,153
10936,text,77,153,206,20,47_denoise.png,1024,1448,283,173
10937,text,291,153,22,18,47_denoise.png,1024,1448,313,171
10938,text,321,151,76,20,47_denoise.png,1024,1448,397,171
10939,text,655,145,28,18,47_denoise.png,1024,1448,683,163
10940,text,736,142,88,20,47_denoise.png,1024,1448,824,162
10941,text,73,171,188,20,47_denoise.png,1024,1448,261,191
10942,text,269,171,140,20,47_denoise.png,1024,1448,409,191
10943,text,72,186,166,26,47_denoise.png,1024,1448,238,212
10944,text,626,222,121,24,47_denoise.png,1024,1448,747,246
10945,text,626,245,265,26,47_denoise.png,1024,1448,891,271
10946,text,627,267,144,20,47_denoise.png,1024,1448,771,287
10947,text,625,285,178,20,47_denoise.png,1024,1448,803,305
10948,text,627,323,64,20,47_denoise.png,1024,1448,691,343
10949,text,114,396,188,26,47_denoise.png,1024,1448,302,422
10950,text,404,395,162,26,47_denoise.png,1024,1448,566,421
10951,text,691,399,198,18,47_denoise.png,1024,1448,889,417
10952,text,159,420,101,24,47_denoise.png,1024,1448,260,444
10953,text,441,419,88,20,47_denoise.png,1024,1448,529,439
10954,text,725,421,130,18,47_denoise.png,1024,1448,855,439
10955,text,85,491,106,20,47_denoise.png,1024,1448,191,511
10956,text,313,491,116,18,47_denoise.png,1024,1448,429,509
10957,text,543,489,86,20,47_denoise.png,1024,1448,629,509
10958,text,665,489,62,20,47_denoise.png,1024,1448,727,509
10959,text,765,489,122,20,47_denoise.png,1024,1448,887,509
10960,text,903,489,34,18,47_denoise.png,1024,1448,937,507
10961,text,70,524,88,24,47_denoise.png,1024,1448,158,548
10962,text,211,524,229,25,47_denoise.png,1024,1448,440,549
10963,text,678,520,68,26,47_denoise.png,1024,1448,746,546
10964,text,819,523,64,20,47_denoise.png,1024,1448,883,543
10965,text,67,1181,104,14,47_denoise.png,1024,1448,171,1195
10966,text,177,1181,48,14,47_denoise.png,1024,1448,225,1195
10967,text,225,1177,468,20,47_denoise.png,1024,1448,693,1197
10968,text,697,1179,196,14,47_denoise.png,1024,1448,893,1193
10969,text,67,1199,150,16,47_denoise.png,1024,1448,217,1215
10970,text,227,1197,386,16,47_denoise.png,1024,1448,613,1213
10971,text,109,1225,68,16,47_denoise.png,1024,1448,177,1241
10972,text,201,1223,54,16,47_denoise.png,1024,1448,255,1239
10973,text,289,1223,52,16,47_denoise.png,1024,1448,341,1239
10974,text,357,1223,46,16,47_denoise.png,1024,1448,403,1239
10975,text,427,1223,40,16,47_denoise.png,1024,1448,467,1239
10976,text,529,1223,56,16,47_denoise.png,1024,1448,585,1239
10977,text,785,1223,32,14,47_denoise.png,1024,1448,817,1237
10978,text,129,1243,52,16,47_denoise.png,1024,1448,181,1259
10979,text,303,1243,44,16,47_denoise.png,1024,1448,347,1259
10980,text,367,1243,36,14,47_denoise.png,1024,1448,403,1257
10981,text,681,1247,60,14,47_denoise.png,1024,1448,741,1261
10982,text,781,1245,52,16,47_denoise.png,1024,1448,833,1261
10983,text,495,1271,24,12,47_denoise.png,1024,1448,519,1283
10984,text,559,1267,52,16,47_denoise.png,1024,1448,611,1283
10985,text,683,1271,54,12,47_denoise.png,1024,1448,737,1283
10986,text,803,1269,30,16,47_denoise.png,1024,1448,833,1285
10987,text,495,1295,38,12,47_denoise.png,1024,1448,533,1307
10988,text,565,1289,44,16,47_denoise.png,1024,1448,609,1305
10989,text,676,1293,69,14,47_denoise.png,1024,1448,745,1307
10990,text,781,1291,52,16,47_denoise.png,1024,1448,833,1307
10991,text,75,57,47,23,47_denoise.png,1024,1448,122,80
10992,text,572,524,19,22,47_denoise.png,1024,1448,591,546
10993,text,907,522,18,25,47_denoise.png,1024,1448,925,547
10994,text,70,1243,11,15,47_denoise.png,1024,1448,81,1258
10995,text,122,52,118,24,47_median.png,1024,1448,240,76
10996,text,630,58,192,24,47_median.png,1024,1448,822,82
10997,text,834,56,104,24,47_median.png,1024,1448,938,80
10998,text,74,75,388,27,47_median.png,1024,1448,462,102
10999,text,75,97,140,20,47_median.png,1024,1448,215,117
11000,text,75,115,64,20,47_median.png,1024,1448,139,135
11001,text,643,115,52,20,47_median.png,1024,1448,695,135
11002,text,757,115,50,20,47_median.png,1024,1448,807,135
11003,text,75,133,32,20,47_median.png,1024,1448,107,153
11004,text,115,133,134,20,47_median.png,1024,1448,249,153
11005,text,259,135,32,18,47_median.png,1024,1448,291,153
11006,text,77,153,206,20,47_median.png,1024,1448,283,173
11007,text,291,153,22,18,47_median.png,1024,1448,313,171
11008,text,321,151,76,20,47_median.png,1024,1448,397,171
11009,text,655,145,28,18,47_median.png,1024,1448,683,163
11010,text,736,142,88,20,47_median.png,1024,1448,824,162
11011,text,73,171,188,20,47_median.png,1024,1448,261,191
11012,text,269,171,140,20,47_median.png,1024,1448,409,191
11013,text,72,186,166,26,47_median.png,1024,1448,238,212
11014,text,626,222,121,24,47_median.png,1024,1448,747,246
11015,text,626,245,265,26,47_median.png,1024,1448,891,271
11016,text,627,267,144,20,47_median.png,1024,1448,771,287
11017,text,625,285,178,20,47_median.png,1024,1448,803,305
11018,text,627,323,64,20,47_median.png,1024,1448,691,343
11019,text,114,396,188,26,47_median.png,1024,1448,302,422
11020,text,404,395,162,26,47_median.png,1024,1448,566,421
11021,text,691,399,198,18,47_median.png,1024,1448,889,417
11022,text,159,420,101,24,47_median.png,1024,1448,260,444
11023,text,441,419,88,20,47_median.png,1024,1448,529,439
11024,text,725,421,130,18,47_median.png,1024,1448,855,439
11025,text,85,491,106,20,47_median.png,1024,1448,191,511
11026,text,313,491,116,18,47_median.png,1024,1448,429,509
11027,text,543,489,86,20,47_median.png,1024,1448,629,509
11028,text,665,489,62,20,47_median.png,1024,1448,727,509
11029,text,765,489,122,20,47_median.png,1024,1448,887,509
11030,text,903,489,34,18,47_median.png,1024,1448,937,507
11031,text,70,524,88,24,47_median.png,1024,1448,158,548
11032,text,211,524,229,25,47_median.png,1024,1448,440,549
11033,text,678,520,68,26,47_median.png,1024,1448,746,546
11034,text,819,523,64,20,47_median.png,1024,1448,883,543
11035,text,67,1181,104,14,47_median.png,1024,1448,171,1195
11036,text,177,1181,48,14,47_median.png,1024,1448,225,1195
11037,text,225,1177,468,20,47_median.png,1024,1448,693,1197
11038,text,697,1179,196,14,47_median.png,1024,1448,893,1193
11039,text,67,1199,150,16,47_median.png,1024,1448,217,1215
11040,text,227,1197,386,16,47_median.png,1024,1448,613,1213
11041,text,109,1225,68,16,47_median.png,1024,1448,177,1241
11042,text,201,1223,54,16,47_median.png,1024,1448,255,1239
11043,text,289,1223,52,16,47_median.png,1024,1448,341,1239
11044,text,357,1223,46,16,47_median.png,1024,1448,403,1239
11045,text,427,1223,40,16,47_median.png,1024,1448,467,1239
11046,text,529,1223,56,16,47_median.png,1024,1448,585,1239
11047,text,785,1223,32,14,47_median.png,1024,1448,817,1237
11048,text,129,1243,52,16,47_median.png,1024,1448,181,1259
11049,text,303,1243,44,16,47_median.png,1024,1448,347,1259
11050,text,367,1243,36,14,47_median.png,1024,1448,403,1257
11051,text,681,1247,60,14,47_median.png,1024,1448,741,1261
11052,text,781,1245,52,16,47_median.png,1024,1448,833,1261
11053,text,495,1271,24,12,47_median.png,1024,1448,519,1283
11054,text,559,1267,52,16,47_median.png,1024,1448,611,1283
11055,text,683,1271,54,12,47_median.png,1024,1448,737,1283
11056,text,803,1269,30,16,47_median.png,1024,1448,833,1285
11057,text,495,1295,38,12,47_median.png,1024,1448,533,1307
11058,text,565,1289,44,16,47_median.png,1024,1448,609,1305
11059,text,676,1293,69,14,47_median.png,1024,1448,745,1307
11060,text,781,1291,52,16,47_median.png,1024,1448,833,1307
11061,text,75,57,47,23,47_median.png,1024,1448,122,80
11062,text,572,524,19,22,47_median.png,1024,1448,591,546
11063,text,907,522,18,25,47_median.png,1024,1448,925,547
11064,text,70,1243,11,15,47_median.png,1024,1448,81,1258
11065,text,94,204,74,24,48.png,1024,1448,168,228
11066,text,174,204,26,24,48.png,1024,1448,200,228
11067,text,332,202,92,24,48.png,1024,1448,424,226
11068,text,568,198,234,24,48.png,1024,1448,802,222
11069,text,568,228,274,24,48.png,1024,1448,842,252
11070,text,116,254,48,24,48.png,1024,1448,164,278
11071,text,246,254,74,24,48.png,1024,1448,320,278
11072,text,388,254,58,24,48.png,1024,1448,446,278
11073,text,112,284,72,24,48.png,1024,1448,184,308
11074,text,238,284,82,24,48.png,1024,1448,320,308
11075,text,658,280,134,24,48.png,1024,1448,792,304
11076,text,566,310,204,24,48.png,1024,1448,770,334
11077,text,92,364,162,24,48.png,1024,1448,254,388
11078,text,103,412,229,26,48.png,1024,1448,332,438
11079,text,378,414,128,24,48.png,1024,1448,506,438
11080,text,558,414,170,24,48.png,1024,1448,728,438
11081,text,764,416,190,26,48.png,1024,1448,954,442
11082,text,594,446,100,24,48.png,1024,1448,694,470
11083,text,96,506,98,24,48.png,1024,1448,194,530
11084,text,234,506,38,24,48.png,1024,1448,272,530
11085,text,394,506,114,26,48.png,1024,1448,508,532
11086,text,704,504,42,24,48.png,1024,1448,746,528
11087,text,762,506,68,24,48.png,1024,1448,830,530
11088,text,868,506,108,24,48.png,1024,1448,976,530
11089,text,117,549,72,20,48.png,1024,1448,189,569
11090,text,282,547,302,25,48.png,1024,1448,584,572
11091,text,703,549,38,20,48.png,1024,1448,741,569
11092,text,768,548,68,24,48.png,1024,1448,836,572
11093,text,906,551,69,20,48.png,1024,1448,975,571
11094,text,111,584,86,20,48.png,1024,1448,197,604
11095,text,282,582,224,24,48.png,1024,1448,506,606
11096,text,702,582,40,24,48.png,1024,1448,742,606
11097,text,773,585,56,20,48.png,1024,1448,829,605
11098,text,928,584,48,24,48.png,1024,1448,976,608
11099,text,85,1145,60,20,48.png,1024,1448,145,1165
11100,text,195,1145,38,20,48.png,1024,1448,233,1165
11101,text,257,1143,72,20,48.png,1024,1448,329,1163
11102,text,490,1140,34,24,48.png,1024,1448,524,1164
11103,text,639,1141,66,20,48.png,1024,1448,705,1161
11104,text,812,1140,92,24,48.png,1024,1448,904,1164
11105,text,114,1172,70,24,48.png,1024,1448,184,1196
11106,text,207,1173,38,20,48.png,1024,1448,245,1193
11107,text,296,1172,58,24,48.png,1024,1448,354,1196
11108,text,463,1176,71,24,48.png,1024,1448,534,1200
11109,text,646,1176,60,24,48.png,1024,1448,706,1200
11110,text,835,1180,79,24,48.png,1024,1448,914,1204
11111,text,386,1208,348,26,48.png,1024,1448,734,1234
11112,text,382,1234,174,24,48.png,1024,1448,556,1258
11113,text,867,1231,34,20,48.png,1024,1448,901,1251
11114,text,152,1277,217,23,48.png,1024,1448,369,1300
11115,text,376,1278,459,21,48.png,1024,1448,835,1299
11116,text,103,1299,143,20,48.png,1024,1448,246,1319
11117,text,378,1298,111,24,48.png,1024,1448,489,1322
11118,text,708,1300,175,21,48.png,1024,1448,883,1321
11119,text,98,1318,96,24,48.png,1024,1448,194,1342
11120,text,201,1319,134,20,48.png,1024,1448,335,1339
11121,text,345,1320,153,19,48.png,1024,1448,498,1339
11122,text,507,1320,75,21,48.png,1024,1448,582,1341
11123,text,178,1338,331,24,48.png,1024,1448,509,1362
11124,text,508,1340,296,22,48.png,1024,1448,804,1362
11125,text,131,1361,82,18,48.png,1024,1448,213,1379
11126,text,222,1361,456,19,48.png,1024,1448,678,1380
11127,text,686,1361,148,21,48.png,1024,1448,834,1382
11128,text,206,1380,418,22,48.png,1024,1448,624,1402
11129,text,633,1379,146,20,48.png,1024,1448,779,1399
11130,text,417,1402,148,17,48.png,1024,1448,565,1419
11131,text,403,288,16,20,48.png,1024,1448,419,308
11132,text,238,549,22,19,48.png,1024,1448,260,568
11133,text,240,584,15,19,48.png,1024,1448,255,603
11134,text,259,1300,111,19,48.png,1024,1448,370,1319
11135,text,503,1300,192,19,48.png,1024,1448,695,1319
11136,text,591,1320,105,19,48.png,1024,1448,696,1339
11137,text,701,1321,177,19,48.png,1024,1448,878,1340
11138,text,94,204,74,24,48_contrasted.png,1024,1448,168,228
11139,text,174,204,26,24,48_contrasted.png,1024,1448,200,228
11140,text,332,202,92,24,48_contrasted.png,1024,1448,424,226
11141,text,568,198,234,24,48_contrasted.png,1024,1448,802,222
11142,text,568,228,274,24,48_contrasted.png,1024,1448,842,252
11143,text,116,254,48,24,48_contrasted.png,1024,1448,164,278
11144,text,246,254,74,24,48_contrasted.png,1024,1448,320,278
11145,text,388,254,58,24,48_contrasted.png,1024,1448,446,278
11146,text,112,284,72,24,48_contrasted.png,1024,1448,184,308
11147,text,238,284,82,24,48_contrasted.png,1024,1448,320,308
11148,text,658,280,134,24,48_contrasted.png,1024,1448,792,304
11149,text,566,310,204,24,48_contrasted.png,1024,1448,770,334
11150,text,92,364,162,24,48_contrasted.png,1024,1448,254,388
11151,text,103,412,229,26,48_contrasted.png,1024,1448,332,438
11152,text,378,414,128,24,48_contrasted.png,1024,1448,506,438
11153,text,558,414,170,24,48_contrasted.png,1024,1448,728,438
11154,text,764,416,190,26,48_contrasted.png,1024,1448,954,442
11155,text,594,446,100,24,48_contrasted.png,1024,1448,694,470
11156,text,96,506,98,24,48_contrasted.png,1024,1448,194,530
11157,text,234,506,38,24,48_contrasted.png,1024,1448,272,530
11158,text,394,506,114,26,48_contrasted.png,1024,1448,508,532
11159,text,704,504,42,24,48_contrasted.png,1024,1448,746,528
11160,text,762,506,68,24,48_contrasted.png,1024,1448,830,530
11161,text,868,506,108,24,48_contrasted.png,1024,1448,976,530
11162,text,117,549,72,20,48_contrasted.png,1024,1448,189,569
11163,text,282,547,302,25,48_contrasted.png,1024,1448,584,572
11164,text,703,549,38,20,48_contrasted.png,1024,1448,741,569
11165,text,768,548,68,24,48_contrasted.png,1024,1448,836,572
11166,text,906,551,69,20,48_contrasted.png,1024,1448,975,571
11167,text,111,584,86,20,48_contrasted.png,1024,1448,197,604
11168,text,282,582,224,24,48_contrasted.png,1024,1448,506,606
11169,text,702,582,40,24,48_contrasted.png,1024,1448,742,606
11170,text,773,585,56,20,48_contrasted.png,1024,1448,829,605
11171,text,928,584,48,24,48_contrasted.png,1024,1448,976,608
11172,text,85,1145,60,20,48_contrasted.png,1024,1448,145,1165
11173,text,195,1145,38,20,48_contrasted.png,1024,1448,233,1165
11174,text,257,1143,72,20,48_contrasted.png,1024,1448,329,1163
11175,text,490,1140,34,24,48_contrasted.png,1024,1448,524,1164
11176,text,639,1141,66,20,48_contrasted.png,1024,1448,705,1161
11177,text,812,1140,92,24,48_contrasted.png,1024,1448,904,1164
11178,text,114,1172,70,24,48_contrasted.png,1024,1448,184,1196
11179,text,207,1173,38,20,48_contrasted.png,1024,1448,245,1193
11180,text,296,1172,58,24,48_contrasted.png,1024,1448,354,1196
11181,text,463,1176,71,24,48_contrasted.png,1024,1448,534,1200
11182,text,646,1176,60,24,48_contrasted.png,1024,1448,706,1200
11183,text,835,1180,79,24,48_contrasted.png,1024,1448,914,1204
11184,text,386,1208,348,26,48_contrasted.png,1024,1448,734,1234
11185,text,382,1234,174,24,48_contrasted.png,1024,1448,556,1258
11186,text,867,1231,34,20,48_contrasted.png,1024,1448,901,1251
11187,text,152,1277,217,23,48_contrasted.png,1024,1448,369,1300
11188,text,376,1278,459,21,48_contrasted.png,1024,1448,835,1299
11189,text,103,1299,143,20,48_contrasted.png,1024,1448,246,1319
11190,text,378,1298,111,24,48_contrasted.png,1024,1448,489,1322
11191,text,708,1300,175,21,48_contrasted.png,1024,1448,883,1321
11192,text,98,1318,96,24,48_contrasted.png,1024,1448,194,1342
11193,text,201,1319,134,20,48_contrasted.png,1024,1448,335,1339
11194,text,345,1320,153,19,48_contrasted.png,1024,1448,498,1339
11195,text,507,1320,75,21,48_contrasted.png,1024,1448,582,1341
11196,text,178,1338,331,24,48_contrasted.png,1024,1448,509,1362
11197,text,508,1340,296,22,48_contrasted.png,1024,1448,804,1362
11198,text,131,1361,82,18,48_contrasted.png,1024,1448,213,1379
11199,text,222,1361,456,19,48_contrasted.png,1024,1448,678,1380
11200,text,686,1361,148,21,48_contrasted.png,1024,1448,834,1382
11201,text,206,1380,418,22,48_contrasted.png,1024,1448,624,1402
11202,text,633,1379,146,20,48_contrasted.png,1024,1448,779,1399
11203,text,417,1402,148,17,48_contrasted.png,1024,1448,565,1419
11204,text,403,288,16,20,48_contrasted.png,1024,1448,419,308
11205,text,238,549,22,19,48_contrasted.png,1024,1448,260,568
11206,text,240,584,15,19,48_contrasted.png,1024,1448,255,603
11207,text,259,1300,111,19,48_contrasted.png,1024,1448,370,1319
11208,text,503,1300,192,19,48_contrasted.png,1024,1448,695,1319
11209,text,591,1320,105,19,48_contrasted.png,1024,1448,696,1339
11210,text,701,1321,177,19,48_contrasted.png,1024,1448,878,1340
11211,text,94,204,74,24,48_denoise.png,1024,1448,168,228
11212,text,174,204,26,24,48_denoise.png,1024,1448,200,228
11213,text,332,202,92,24,48_denoise.png,1024,1448,424,226
11214,text,568,198,234,24,48_denoise.png,1024,1448,802,222
11215,text,568,228,274,24,48_denoise.png,1024,1448,842,252
11216,text,116,254,48,24,48_denoise.png,1024,1448,164,278
11217,text,246,254,74,24,48_denoise.png,1024,1448,320,278
11218,text,388,254,58,24,48_denoise.png,1024,1448,446,278
11219,text,112,284,72,24,48_denoise.png,1024,1448,184,308
11220,text,238,284,82,24,48_denoise.png,1024,1448,320,308
11221,text,658,280,134,24,48_denoise.png,1024,1448,792,304
11222,text,566,310,204,24,48_denoise.png,1024,1448,770,334
11223,text,92,364,162,24,48_denoise.png,1024,1448,254,388
11224,text,103,412,229,26,48_denoise.png,1024,1448,332,438
11225,text,378,414,128,24,48_denoise.png,1024,1448,506,438
11226,text,558,414,170,24,48_denoise.png,1024,1448,728,438
11227,text,764,416,190,26,48_denoise.png,1024,1448,954,442
11228,text,594,446,100,24,48_denoise.png,1024,1448,694,470
11229,text,96,506,98,24,48_denoise.png,1024,1448,194,530
11230,text,234,506,38,24,48_denoise.png,1024,1448,272,530
11231,text,394,506,114,26,48_denoise.png,1024,1448,508,532
11232,text,704,504,42,24,48_denoise.png,1024,1448,746,528
11233,text,762,506,68,24,48_denoise.png,1024,1448,830,530
11234,text,868,506,108,24,48_denoise.png,1024,1448,976,530
11235,text,117,549,72,20,48_denoise.png,1024,1448,189,569
11236,text,282,547,302,25,48_denoise.png,1024,1448,584,572
11237,text,703,549,38,20,48_denoise.png,1024,1448,741,569
11238,text,768,548,68,24,48_denoise.png,1024,1448,836,572
11239,text,906,551,69,20,48_denoise.png,1024,1448,975,571
11240,text,111,584,86,20,48_denoise.png,1024,1448,197,604
11241,text,282,582,224,24,48_denoise.png,1024,1448,506,606
11242,text,702,582,40,24,48_denoise.png,1024,1448,742,606
11243,text,773,585,56,20,48_denoise.png,1024,1448,829,605
11244,text,928,584,48,24,48_denoise.png,1024,1448,976,608
11245,text,85,1145,60,20,48_denoise.png,1024,1448,145,1165
11246,text,195,1145,38,20,48_denoise.png,1024,1448,233,1165
11247,text,257,1143,72,20,48_denoise.png,1024,1448,329,1163
11248,text,490,1140,34,24,48_denoise.png,1024,1448,524,1164
11249,text,639,1141,66,20,48_denoise.png,1024,1448,705,1161
11250,text,812,1140,92,24,48_denoise.png,1024,1448,904,1164
11251,text,114,1172,70,24,48_denoise.png,1024,1448,184,1196
11252,text,207,1173,38,20,48_denoise.png,1024,1448,245,1193
11253,text,296,1172,58,24,48_denoise.png,1024,1448,354,1196
11254,text,463,1176,71,24,48_denoise.png,1024,1448,534,1200
11255,text,646,1176,60,24,48_denoise.png,1024,1448,706,1200
11256,text,835,1180,79,24,48_denoise.png,1024,1448,914,1204
11257,text,386,1208,348,26,48_denoise.png,1024,1448,734,1234
11258,text,382,1234,174,24,48_denoise.png,1024,1448,556,1258
11259,text,867,1231,34,20,48_denoise.png,1024,1448,901,1251
11260,text,152,1277,217,23,48_denoise.png,1024,1448,369,1300
11261,text,376,1278,459,21,48_denoise.png,1024,1448,835,1299
11262,text,103,1299,143,20,48_denoise.png,1024,1448,246,1319
11263,text,378,1298,111,24,48_denoise.png,1024,1448,489,1322
11264,text,708,1300,175,21,48_denoise.png,1024,1448,883,1321
11265,text,98,1318,96,24,48_denoise.png,1024,1448,194,1342
11266,text,201,1319,134,20,48_denoise.png,1024,1448,335,1339
11267,text,345,1320,153,19,48_denoise.png,1024,1448,498,1339
11268,text,507,1320,75,21,48_denoise.png,1024,1448,582,1341
11269,text,178,1338,331,24,48_denoise.png,1024,1448,509,1362
11270,text,508,1340,296,22,48_denoise.png,1024,1448,804,1362
11271,text,131,1361,82,18,48_denoise.png,1024,1448,213,1379
11272,text,222,1361,456,19,48_denoise.png,1024,1448,678,1380
11273,text,686,1361,148,21,48_denoise.png,1024,1448,834,1382
11274,text,206,1380,418,22,48_denoise.png,1024,1448,624,1402
11275,text,633,1379,146,20,48_denoise.png,1024,1448,779,1399
11276,text,417,1402,148,17,48_denoise.png,1024,1448,565,1419
11277,text,403,288,16,20,48_denoise.png,1024,1448,419,308
11278,text,238,549,22,19,48_denoise.png,1024,1448,260,568
11279,text,240,584,15,19,48_denoise.png,1024,1448,255,603
11280,text,259,1300,111,19,48_denoise.png,1024,1448,370,1319
11281,text,503,1300,192,19,48_denoise.png,1024,1448,695,1319
11282,text,591,1320,105,19,48_denoise.png,1024,1448,696,1339
11283,text,701,1321,177,19,48_denoise.png,1024,1448,878,1340
11284,text,94,204,74,24,48_median.png,1024,1448,168,228
11285,text,174,204,26,24,48_median.png,1024,1448,200,228
11286,text,332,202,92,24,48_median.png,1024,1448,424,226
11287,text,568,198,234,24,48_median.png,1024,1448,802,222
11288,text,568,228,274,24,48_median.png,1024,1448,842,252
11289,text,116,254,48,24,48_median.png,1024,1448,164,278
11290,text,246,254,74,24,48_median.png,1024,1448,320,278
11291,text,388,254,58,24,48_median.png,1024,1448,446,278
11292,text,112,284,72,24,48_median.png,1024,1448,184,308
11293,text,238,284,82,24,48_median.png,1024,1448,320,308
11294,text,658,280,134,24,48_median.png,1024,1448,792,304
11295,text,566,310,204,24,48_median.png,1024,1448,770,334
11296,text,92,364,162,24,48_median.png,1024,1448,254,388
11297,text,103,412,229,26,48_median.png,1024,1448,332,438
11298,text,378,414,128,24,48_median.png,1024,1448,506,438
11299,text,558,414,170,24,48_median.png,1024,1448,728,438
11300,text,764,416,190,26,48_median.png,1024,1448,954,442
11301,text,594,446,100,24,48_median.png,1024,1448,694,470
11302,text,96,506,98,24,48_median.png,1024,1448,194,530
11303,text,234,506,38,24,48_median.png,1024,1448,272,530
11304,text,394,506,114,26,48_median.png,1024,1448,508,532
11305,text,704,504,42,24,48_median.png,1024,1448,746,528
11306,text,762,506,68,24,48_median.png,1024,1448,830,530
11307,text,868,506,108,24,48_median.png,1024,1448,976,530
11308,text,117,549,72,20,48_median.png,1024,1448,189,569
11309,text,282,547,302,25,48_median.png,1024,1448,584,572
11310,text,703,549,38,20,48_median.png,1024,1448,741,569
11311,text,768,548,68,24,48_median.png,1024,1448,836,572
11312,text,906,551,69,20,48_median.png,1024,1448,975,571
11313,text,111,584,86,20,48_median.png,1024,1448,197,604
11314,text,282,582,224,24,48_median.png,1024,1448,506,606
11315,text,702,582,40,24,48_median.png,1024,1448,742,606
11316,text,773,585,56,20,48_median.png,1024,1448,829,605
11317,text,928,584,48,24,48_median.png,1024,1448,976,608
11318,text,85,1145,60,20,48_median.png,1024,1448,145,1165
11319,text,195,1145,38,20,48_median.png,1024,1448,233,1165
11320,text,257,1143,72,20,48_median.png,1024,1448,329,1163
11321,text,490,1140,34,24,48_median.png,1024,1448,524,1164
11322,text,639,1141,66,20,48_median.png,1024,1448,705,1161
11323,text,812,1140,92,24,48_median.png,1024,1448,904,1164
11324,text,114,1172,70,24,48_median.png,1024,1448,184,1196
11325,text,207,1173,38,20,48_median.png,1024,1448,245,1193
11326,text,296,1172,58,24,48_median.png,1024,1448,354,1196
11327,text,463,1176,71,24,48_median.png,1024,1448,534,1200
11328,text,646,1176,60,24,48_median.png,1024,1448,706,1200
11329,text,835,1180,79,24,48_median.png,1024,1448,914,1204
11330,text,386,1208,348,26,48_median.png,1024,1448,734,1234
11331,text,382,1234,174,24,48_median.png,1024,1448,556,1258
11332,text,867,1231,34,20,48_median.png,1024,1448,901,1251
11333,text,152,1277,217,23,48_median.png,1024,1448,369,1300
11334,text,376,1278,459,21,48_median.png,1024,1448,835,1299
11335,text,103,1299,143,20,48_median.png,1024,1448,246,1319
11336,text,378,1298,111,24,48_median.png,1024,1448,489,1322
11337,text,708,1300,175,21,48_median.png,1024,1448,883,1321
11338,text,98,1318,96,24,48_median.png,1024,1448,194,1342
11339,text,201,1319,134,20,48_median.png,1024,1448,335,1339
11340,text,345,1320,153,19,48_median.png,1024,1448,498,1339
11341,text,507,1320,75,21,48_median.png,1024,1448,582,1341
11342,text,178,1338,331,24,48_median.png,1024,1448,509,1362
11343,text,508,1340,296,22,48_median.png,1024,1448,804,1362
11344,text,131,1361,82,18,48_median.png,1024,1448,213,1379
11345,text,222,1361,456,19,48_median.png,1024,1448,678,1380
11346,text,686,1361,148,21,48_median.png,1024,1448,834,1382
11347,text,206,1380,418,22,48_median.png,1024,1448,624,1402
11348,text,633,1379,146,20,48_median.png,1024,1448,779,1399
11349,text,417,1402,148,17,48_median.png,1024,1448,565,1419
11350,text,403,288,16,20,48_median.png,1024,1448,419,308
11351,text,238,549,22,19,48_median.png,1024,1448,260,568
11352,text,240,584,15,19,48_median.png,1024,1448,255,603
11353,text,259,1300,111,19,48_median.png,1024,1448,370,1319
11354,text,503,1300,192,19,48_median.png,1024,1448,695,1319
11355,text,591,1320,105,19,48_median.png,1024,1448,696,1339
11356,text,701,1321,177,19,48_median.png,1024,1448,878,1340
11357,text,173,101,252,60,49.png,1024,1430,425,161
11358,text,175,151,235,26,49.png,1024,1430,410,177
11359,text,147,179,184,20,49.png,1024,1430,331,199
11360,text,339,174,111,26,49.png,1024,1430,450,200
11361,text,23,223,84,20,49.png,1024,1430,107,243
11362,text,499,215,184,20,49.png,1024,1430,683,235
11363,text,499,237,32,18,49.png,1024,1430,531,255
11364,text,539,235,146,20,49.png,1024,1430,685,255
11365,text,499,253,366,20,49.png,1024,1430,865,273
11366,text,29,275,80,18,49.png,1024,1430,109,293
11367,text,195,273,106,18,49.png,1024,1430,301,291
11368,text,499,273,106,20,49.png,1024,1430,605,293
11369,text,29,303,38,16,49.png,1024,1430,67,319
11370,text,193,299,90,18,49.png,1024,1430,283,317
11371,text,501,295,48,16,49.png,1024,1430,549,311
11372,text,27,325,78,20,49.png,1024,1430,105,345
11373,text,193,325,90,20,49.png,1024,1430,283,345
11374,text,29,353,122,18,49.png,1024,1430,151,371
11375,text,191,346,159,26,49.png,1024,1430,350,372
11376,text,21,401,136,20,49.png,1024,1430,157,421
11377,text,26,436,93,24,49.png,1024,1430,119,460
11378,text,755,435,60,18,49.png,1024,1430,815,453
11379,text,825,435,34,18,49.png,1024,1430,859,453
11380,text,865,433,88,20,49.png,1024,1430,953,453
11381,text,25,466,95,26,49.png,1024,1430,120,492
11382,text,127,469,168,20,49.png,1024,1430,295,489
11383,text,707,467,44,18,49.png,1024,1430,751,485
11384,text,769,465,90,20,49.png,1024,1430,859,485
11385,text,897,465,58,20,49.png,1024,1430,955,485
11386,text,699,537,78,18,49.png,1024,1430,777,555
11387,text,893,535,56,20,49.png,1024,1430,949,555
11388,text,24,556,410,24,49.png,1024,1430,434,580
11389,text,693,565,82,20,49.png,1024,1430,775,585
11390,text,903,565,46,20,49.png,1024,1430,949,585
11391,text,25,581,364,18,49.png,1024,1430,389,599
11392,text,591,593,184,20,49.png,1024,1430,775,613
11393,text,893,593,56,20,49.png,1024,1430,949,613
11394,text,21,657,180,20,49.png,1024,1430,201,677
11395,text,23,679,64,18,49.png,1024,1430,87,697
11396,text,21,707,68,20,49.png,1024,1430,89,727
11397,text,23,741,312,18,49.png,1024,1430,335,759
11398,text,249,1301,24,18,49.png,1024,1430,273,1319
11399,text,279,1301,294,20,49.png,1024,1430,573,1321
11400,text,585,1301,88,18,49.png,1024,1430,673,1319
11401,text,685,1301,48,16,49.png,1024,1430,733,1317
11402,text,178,1320,235,18,49.png,1024,1430,413,1338
11403,text,221,1337,178,20,49.png,1024,1430,399,1357
11404,text,439,1337,146,20,49.png,1024,1430,585,1357
11405,text,592,1338,170,19,49.png,1024,1430,762,1357
11406,text,665,435,35,17,49.png,1024,1430,700,452
11407,text,687,466,15,18,49.png,1024,1430,702,484
11408,text,720,434,16,20,49.png,1024,1430,736,454
11409,text,128,435,109,25,49.png,1024,1430,237,460
11410,text,418,1319,143,18,49.png,1024,1430,561,1337
11411,text,562,1319,244,18,49.png,1024,1430,806,1337
11412,text,403,1337,25,20,49.png,1024,1430,428,1357
11413,text,173,101,252,60,49_contrasted.png,1024,1430,425,161
11414,text,175,151,235,26,49_contrasted.png,1024,1430,410,177
11415,text,147,179,184,20,49_contrasted.png,1024,1430,331,199
11416,text,339,174,111,26,49_contrasted.png,1024,1430,450,200
11417,text,23,223,84,20,49_contrasted.png,1024,1430,107,243
11418,text,499,215,184,20,49_contrasted.png,1024,1430,683,235
11419,text,499,237,32,18,49_contrasted.png,1024,1430,531,255
11420,text,539,235,146,20,49_contrasted.png,1024,1430,685,255
11421,text,499,253,366,20,49_contrasted.png,1024,1430,865,273
11422,text,29,275,80,18,49_contrasted.png,1024,1430,109,293
11423,text,195,273,106,18,49_contrasted.png,1024,1430,301,291
11424,text,499,273,106,20,49_contrasted.png,1024,1430,605,293
11425,text,29,303,38,16,49_contrasted.png,1024,1430,67,319
11426,text,193,299,90,18,49_contrasted.png,1024,1430,283,317
11427,text,501,295,48,16,49_contrasted.png,1024,1430,549,311
11428,text,27,325,78,20,49_contrasted.png,1024,1430,105,345
11429,text,193,325,90,20,49_contrasted.png,1024,1430,283,345
11430,text,29,353,122,18,49_contrasted.png,1024,1430,151,371
11431,text,191,346,159,26,49_contrasted.png,1024,1430,350,372
11432,text,21,401,136,20,49_contrasted.png,1024,1430,157,421
11433,text,26,436,93,24,49_contrasted.png,1024,1430,119,460
11434,text,755,435,60,18,49_contrasted.png,1024,1430,815,453
11435,text,825,435,34,18,49_contrasted.png,1024,1430,859,453
11436,text,865,433,88,20,49_contrasted.png,1024,1430,953,453
11437,text,25,466,95,26,49_contrasted.png,1024,1430,120,492
11438,text,127,469,168,20,49_contrasted.png,1024,1430,295,489
11439,text,707,467,44,18,49_contrasted.png,1024,1430,751,485
11440,text,769,465,90,20,49_contrasted.png,1024,1430,859,485
11441,text,897,465,58,20,49_contrasted.png,1024,1430,955,485
11442,text,699,537,78,18,49_contrasted.png,1024,1430,777,555
11443,text,893,535,56,20,49_contrasted.png,1024,1430,949,555
11444,text,24,556,410,24,49_contrasted.png,1024,1430,434,580
11445,text,693,565,82,20,49_contrasted.png,1024,1430,775,585
11446,text,903,565,46,20,49_contrasted.png,1024,1430,949,585
11447,text,25,581,364,18,49_contrasted.png,1024,1430,389,599
11448,text,591,593,184,20,49_contrasted.png,1024,1430,775,613
11449,text,893,593,56,20,49_contrasted.png,1024,1430,949,613
11450,text,21,657,180,20,49_contrasted.png,1024,1430,201,677
11451,text,23,679,64,18,49_contrasted.png,1024,1430,87,697
11452,text,21,707,68,20,49_contrasted.png,1024,1430,89,727
11453,text,23,741,312,18,49_contrasted.png,1024,1430,335,759
11454,text,249,1301,24,18,49_contrasted.png,1024,1430,273,1319
11455,text,279,1301,294,20,49_contrasted.png,1024,1430,573,1321
11456,text,585,1301,88,18,49_contrasted.png,1024,1430,673,1319
11457,text,685,1301,48,16,49_contrasted.png,1024,1430,733,1317
11458,text,178,1320,235,18,49_contrasted.png,1024,1430,413,1338
11459,text,221,1337,178,20,49_contrasted.png,1024,1430,399,1357
11460,text,439,1337,146,20,49_contrasted.png,1024,1430,585,1357
11461,text,592,1338,170,19,49_contrasted.png,1024,1430,762,1357
11462,text,665,435,35,17,49_contrasted.png,1024,1430,700,452
11463,text,687,466,15,18,49_contrasted.png,1024,1430,702,484
11464,text,720,434,16,20,49_contrasted.png,1024,1430,736,454
11465,text,128,435,109,25,49_contrasted.png,1024,1430,237,460
11466,text,418,1319,143,18,49_contrasted.png,1024,1430,561,1337
11467,text,562,1319,244,18,49_contrasted.png,1024,1430,806,1337
11468,text,403,1337,25,20,49_contrasted.png,1024,1430,428,1357
11469,text,173,101,252,60,49_denoise.png,1024,1430,425,161
11470,text,175,151,235,26,49_denoise.png,1024,1430,410,177
11471,text,147,179,184,20,49_denoise.png,1024,1430,331,199
11472,text,339,174,111,26,49_denoise.png,1024,1430,450,200
11473,text,23,223,84,20,49_denoise.png,1024,1430,107,243
11474,text,499,215,184,20,49_denoise.png,1024,1430,683,235
11475,text,499,237,32,18,49_denoise.png,1024,1430,531,255
11476,text,539,235,146,20,49_denoise.png,1024,1430,685,255
11477,text,499,253,366,20,49_denoise.png,1024,1430,865,273
11478,text,29,275,80,18,49_denoise.png,1024,1430,109,293
11479,text,195,273,106,18,49_denoise.png,1024,1430,301,291
11480,text,499,273,106,20,49_denoise.png,1024,1430,605,293
11481,text,29,303,38,16,49_denoise.png,1024,1430,67,319
11482,text,193,299,90,18,49_denoise.png,1024,1430,283,317
11483,text,501,295,48,16,49_denoise.png,1024,1430,549,311
11484,text,27,325,78,20,49_denoise.png,1024,1430,105,345
11485,text,193,325,90,20,49_denoise.png,1024,1430,283,345
11486,text,29,353,122,18,49_denoise.png,1024,1430,151,371
11487,text,191,346,159,26,49_denoise.png,1024,1430,350,372
11488,text,21,401,136,20,49_denoise.png,1024,1430,157,421
11489,text,26,436,93,24,49_denoise.png,1024,1430,119,460
11490,text,755,435,60,18,49_denoise.png,1024,1430,815,453
11491,text,825,435,34,18,49_denoise.png,1024,1430,859,453
11492,text,865,433,88,20,49_denoise.png,1024,1430,953,453
11493,text,25,466,95,26,49_denoise.png,1024,1430,120,492
11494,text,127,469,168,20,49_denoise.png,1024,1430,295,489
11495,text,707,467,44,18,49_denoise.png,1024,1430,751,485
11496,text,769,465,90,20,49_denoise.png,1024,1430,859,485
11497,text,897,465,58,20,49_denoise.png,1024,1430,955,485
11498,text,699,537,78,18,49_denoise.png,1024,1430,777,555
11499,text,893,535,56,20,49_denoise.png,1024,1430,949,555
11500,text,24,556,410,24,49_denoise.png,1024,1430,434,580
11501,text,693,565,82,20,49_denoise.png,1024,1430,775,585
11502,text,903,565,46,20,49_denoise.png,1024,1430,949,585
11503,text,25,581,364,18,49_denoise.png,1024,1430,389,599
11504,text,591,593,184,20,49_denoise.png,1024,1430,775,613
11505,text,893,593,56,20,49_denoise.png,1024,1430,949,613
11506,text,21,657,180,20,49_denoise.png,1024,1430,201,677
11507,text,23,679,64,18,49_denoise.png,1024,1430,87,697
11508,text,21,707,68,20,49_denoise.png,1024,1430,89,727
11509,text,23,741,312,18,49_denoise.png,1024,1430,335,759
11510,text,249,1301,24,18,49_denoise.png,1024,1430,273,1319
11511,text,279,1301,294,20,49_denoise.png,1024,1430,573,1321
11512,text,585,1301,88,18,49_denoise.png,1024,1430,673,1319
11513,text,685,1301,48,16,49_denoise.png,1024,1430,733,1317
11514,text,178,1320,235,18,49_denoise.png,1024,1430,413,1338
11515,text,221,1337,178,20,49_denoise.png,1024,1430,399,1357
11516,text,439,1337,146,20,49_denoise.png,1024,1430,585,1357
11517,text,592,1338,170,19,49_denoise.png,1024,1430,762,1357
11518,text,665,435,35,17,49_denoise.png,1024,1430,700,452
11519,text,687,466,15,18,49_denoise.png,1024,1430,702,484
11520,text,720,434,16,20,49_denoise.png,1024,1430,736,454
11521,text,128,435,109,25,49_denoise.png,1024,1430,237,460
11522,text,418,1319,143,18,49_denoise.png,1024,1430,561,1337
11523,text,562,1319,244,18,49_denoise.png,1024,1430,806,1337
11524,text,403,1337,25,20,49_denoise.png,1024,1430,428,1357
11525,text,173,101,252,60,49_median.png,1024,1430,425,161
11526,text,175,151,235,26,49_median.png,1024,1430,410,177
11527,text,147,179,184,20,49_median.png,1024,1430,331,199
11528,text,339,174,111,26,49_median.png,1024,1430,450,200
11529,text,23,223,84,20,49_median.png,1024,1430,107,243
11530,text,499,215,184,20,49_median.png,1024,1430,683,235
11531,text,499,237,32,18,49_median.png,1024,1430,531,255
11532,text,539,235,146,20,49_median.png,1024,1430,685,255
11533,text,499,253,366,20,49_median.png,1024,1430,865,273
11534,text,29,275,80,18,49_median.png,1024,1430,109,293
11535,text,195,273,106,18,49_median.png,1024,1430,301,291
11536,text,499,273,106,20,49_median.png,1024,1430,605,293
11537,text,29,303,38,16,49_median.png,1024,1430,67,319
11538,text,193,299,90,18,49_median.png,1024,1430,283,317
11539,text,501,295,48,16,49_median.png,1024,1430,549,311
11540,text,27,325,78,20,49_median.png,1024,1430,105,345
11541,text,193,325,90,20,49_median.png,1024,1430,283,345
11542,text,29,353,122,18,49_median.png,1024,1430,151,371
11543,text,191,346,159,26,49_median.png,1024,1430,350,372
11544,text,21,401,136,20,49_median.png,1024,1430,157,421
11545,text,26,436,93,24,49_median.png,1024,1430,119,460
11546,text,755,435,60,18,49_median.png,1024,1430,815,453
11547,text,825,435,34,18,49_median.png,1024,1430,859,453
11548,text,865,433,88,20,49_median.png,1024,1430,953,453
11549,text,25,466,95,26,49_median.png,1024,1430,120,492
11550,text,127,469,168,20,49_median.png,1024,1430,295,489
11551,text,707,467,44,18,49_median.png,1024,1430,751,485
11552,text,769,465,90,20,49_median.png,1024,1430,859,485
11553,text,897,465,58,20,49_median.png,1024,1430,955,485
11554,text,699,537,78,18,49_median.png,1024,1430,777,555
11555,text,893,535,56,20,49_median.png,1024,1430,949,555
11556,text,24,556,410,24,49_median.png,1024,1430,434,580
11557,text,693,565,82,20,49_median.png,1024,1430,775,585
11558,text,903,565,46,20,49_median.png,1024,1430,949,585
11559,text,25,581,364,18,49_median.png,1024,1430,389,599
11560,text,591,593,184,20,49_median.png,1024,1430,775,613
11561,text,893,593,56,20,49_median.png,1024,1430,949,613
11562,text,21,657,180,20,49_median.png,1024,1430,201,677
11563,text,23,679,64,18,49_median.png,1024,1430,87,697
11564,text,21,707,68,20,49_median.png,1024,1430,89,727
11565,text,23,741,312,18,49_median.png,1024,1430,335,759
11566,text,249,1301,24,18,49_median.png,1024,1430,273,1319
11567,text,279,1301,294,20,49_median.png,1024,1430,573,1321
11568,text,585,1301,88,18,49_median.png,1024,1430,673,1319
11569,text,685,1301,48,16,49_median.png,1024,1430,733,1317
11570,text,178,1320,235,18,49_median.png,1024,1430,413,1338
11571,text,221,1337,178,20,49_median.png,1024,1430,399,1357
11572,text,439,1337,146,20,49_median.png,1024,1430,585,1357
11573,text,592,1338,170,19,49_median.png,1024,1430,762,1357
11574,text,665,435,35,17,49_median.png,1024,1430,700,452
11575,text,687,466,15,18,49_median.png,1024,1430,702,484
11576,text,720,434,16,20,49_median.png,1024,1430,736,454
11577,text,128,435,109,25,49_median.png,1024,1430,237,460
11578,text,418,1319,143,18,49_median.png,1024,1430,561,1337
11579,text,562,1319,244,18,49_median.png,1024,1430,806,1337
11580,text,403,1337,25,20,49_median.png,1024,1430,428,1357
11581,text,363,93,162,40,4_contrasted.png,1024,1430,525,133
11582,text,198,139,520,27,4_contrasted.png,1024,1430,718,166
11583,text,627,241,132,20,4_contrasted.png,1024,1430,759,261
11584,text,629,259,246,20,4_contrasted.png,1024,1430,875,279
11585,text,625,279,162,20,4_contrasted.png,1024,1430,787,299
11586,text,631,297,106,20,4_contrasted.png,1024,1430,737,317
11587,text,375,393,152,42,4_contrasted.png,1024,1430,527,435
11588,text,41,469,38,16,4_contrasted.png,1024,1430,79,485
11589,text,69,517,106,20,4_contrasted.png,1024,1430,175,537
11590,text,183,517,70,20,4_contrasted.png,1024,1430,253,537
11591,text,311,515,50,20,4_contrasted.png,1024,1430,361,535
11592,text,387,515,68,20,4_contrasted.png,1024,1430,455,535
11593,text,523,513,48,20,4_contrasted.png,1024,1430,571,533
11594,text,709,511,118,20,4_contrasted.png,1024,1430,827,531
11595,text,849,509,68,20,4_contrasted.png,1024,1430,917,529
11596,text,61,577,74,16,4_contrasted.png,1024,1430,135,593
11597,text,299,575,88,18,4_contrasted.png,1024,1430,387,593
11598,text,571,569,30,18,4_contrasted.png,1024,1430,601,587
11599,text,639,571,78,16,4_contrasted.png,1024,1430,717,587
11600,text,737,571,56,18,4_contrasted.png,1024,1430,793,589
11601,text,825,571,84,16,4_contrasted.png,1024,1430,909,587
11602,text,41,607,94,18,4_contrasted.png,1024,1430,135,625
11603,text,165,607,188,16,4_contrasted.png,1024,1430,353,623
11604,text,671,603,58,17,4_contrasted.png,1024,1430,729,620
11605,text,871,605,46,16,4_contrasted.png,1024,1430,917,621
11606,text,43,625,93,15,4_contrasted.png,1024,1430,136,640
11607,text,207,623,177,15,4_contrasted.png,1024,1430,384,638
11608,text,671,620,58,15,4_contrasted.png,1024,1430,729,635
11609,text,871,619,47,16,4_contrasted.png,1024,1430,918,635
11610,text,43,639,92,16,4_contrasted.png,1024,1430,135,655
11611,text,165,638,196,13,4_contrasted.png,1024,1430,361,651
11612,text,673,635,55,16,4_contrasted.png,1024,1430,728,651
11613,text,42,655,95,16,4_contrasted.png,1024,1430,137,671
11614,text,165,651,184,17,4_contrasted.png,1024,1430,349,668
11615,text,673,651,56,16,4_contrasted.png,1024,1430,729,667
11616,text,41,670,96,15,4_contrasted.png,1024,1430,137,685
11617,text,164,668,224,16,4_contrasted.png,1024,1430,388,684
11618,text,871,665,47,16,4_contrasted.png,1024,1430,918,681
11619,text,43,685,94,15,4_contrasted.png,1024,1430,137,700
11620,text,165,684,189,15,4_contrasted.png,1024,1430,354,699
11621,text,673,681,56,16,4_contrasted.png,1024,1430,729,697
11622,text,871,681,47,14,4_contrasted.png,1024,1430,918,695
11623,text,41,701,72,16,4_contrasted.png,1024,1430,113,717
11624,text,162,698,372,16,4_contrasted.png,1024,1430,534,714
11625,text,671,696,58,17,4_contrasted.png,1024,1430,729,713
11626,text,869,693,50,18,4_contrasted.png,1024,1430,919,711
11627,text,135,1055,154,20,4_contrasted.png,1024,1430,289,1075
11628,text,731,1063,70,20,4_contrasted.png,1024,1430,801,1083
11629,text,859,1063,68,20,4_contrasted.png,1024,1430,927,1083
11630,text,187,1083,38,18,4_contrasted.png,1024,1430,225,1101
11631,text,731,1093,90,20,4_contrasted.png,1024,1430,821,1113
11632,text,871,1093,56,20,4_contrasted.png,1024,1430,927,1113
11633,text,162,1106,86,18,4_contrasted.png,1024,1430,248,1124
11634,text,730,1122,82,24,4_contrasted.png,1024,1430,812,1146
11635,text,860,1122,68,24,4_contrasted.png,1024,1430,928,1146
11636,text,183,1139,28,16,4_contrasted.png,1024,1430,211,1155
11637,text,269,1137,32,18,4_contrasted.png,1024,1430,301,1155
11638,text,36,1168,378,24,4_contrasted.png,1024,1430,414,1192
11639,text,35,1195,162,16,4_contrasted.png,1024,1430,197,1211
11640,text,195,1191,151,21,4_contrasted.png,1024,1430,346,1212
11641,text,348,1223,276,18,4_contrasted.png,1024,1430,624,1241
11642,text,135,1241,138,20,4_contrasted.png,1024,1430,273,1261
11643,text,283,1243,86,18,4_contrasted.png,1024,1430,369,1261
11644,text,383,1241,26,18,4_contrasted.png,1024,1430,409,1259
11645,text,419,1239,274,20,4_contrasted.png,1024,1430,693,1259
11646,text,701,1241,28,16,4_contrasted.png,1024,1430,729,1257
11647,text,737,1239,90,18,4_contrasted.png,1024,1430,827,1257
11648,text,169,1261,24,20,4_contrasted.png,1024,1430,193,1281
11649,text,199,1260,82,19,4_contrasted.png,1024,1430,281,1279
11650,text,305,1259,82,18,4_contrasted.png,1024,1430,387,1277
11651,text,407,1257,126,20,4_contrasted.png,1024,1430,533,1277
11652,text,552,1254,144,24,4_contrasted.png,1024,1430,696,1278
11653,text,164,624,44,16,4_contrasted.png,1024,1430,208,640
11654,text,586,606,14,14,4_contrasted.png,1024,1430,600,620
11655,text,586,620,14,16,4_contrasted.png,1024,1430,600,636
11656,text,585,635,14,17,4_contrasted.png,1024,1430,599,652
11657,text,586,651,14,15,4_contrasted.png,1024,1430,600,666
11658,text,586,667,14,14,4_contrasted.png,1024,1430,600,681
11659,text,586,681,14,15,4_contrasted.png,1024,1430,600,696
11660,text,586,697,13,17,4_contrasted.png,1024,1430,599,714
11661,text,672,667,58,13,4_contrasted.png,1024,1430,730,680
11662,text,870,634,50,15,4_contrasted.png,1024,1430,920,649
11663,text,870,649,48,16,4_contrasted.png,1024,1430,918,665
11664,text,705,1257,159,18,4_contrasted.png,1024,1430,864,1275
11665,text,363,93,162,40,4_denoise.png,1024,1430,525,133
11666,text,198,139,520,27,4_denoise.png,1024,1430,718,166
11667,text,627,241,132,20,4_denoise.png,1024,1430,759,261
11668,text,629,259,246,20,4_denoise.png,1024,1430,875,279
11669,text,625,279,162,20,4_denoise.png,1024,1430,787,299
11670,text,631,297,106,20,4_denoise.png,1024,1430,737,317
11671,text,375,393,152,42,4_denoise.png,1024,1430,527,435
11672,text,41,469,38,16,4_denoise.png,1024,1430,79,485
11673,text,69,517,106,20,4_denoise.png,1024,1430,175,537
11674,text,183,517,70,20,4_denoise.png,1024,1430,253,537
11675,text,311,515,50,20,4_denoise.png,1024,1430,361,535
11676,text,387,515,68,20,4_denoise.png,1024,1430,455,535
11677,text,523,513,48,20,4_denoise.png,1024,1430,571,533
11678,text,709,511,118,20,4_denoise.png,1024,1430,827,531
11679,text,849,509,68,20,4_denoise.png,1024,1430,917,529
11680,text,61,577,74,16,4_denoise.png,1024,1430,135,593
11681,text,299,575,88,18,4_denoise.png,1024,1430,387,593
11682,text,571,569,30,18,4_denoise.png,1024,1430,601,587
11683,text,639,571,78,16,4_denoise.png,1024,1430,717,587
11684,text,737,571,56,18,4_denoise.png,1024,1430,793,589
11685,text,825,571,84,16,4_denoise.png,1024,1430,909,587
11686,text,41,607,94,18,4_denoise.png,1024,1430,135,625
11687,text,165,607,188,16,4_denoise.png,1024,1430,353,623
11688,text,671,603,58,17,4_denoise.png,1024,1430,729,620
11689,text,871,605,46,16,4_denoise.png,1024,1430,917,621
11690,text,43,625,93,15,4_denoise.png,1024,1430,136,640
11691,text,207,623,177,15,4_denoise.png,1024,1430,384,638
11692,text,671,620,58,15,4_denoise.png,1024,1430,729,635
11693,text,871,619,47,16,4_denoise.png,1024,1430,918,635
11694,text,43,639,92,16,4_denoise.png,1024,1430,135,655
11695,text,165,638,196,13,4_denoise.png,1024,1430,361,651
11696,text,673,635,55,16,4_denoise.png,1024,1430,728,651
11697,text,42,655,95,16,4_denoise.png,1024,1430,137,671
11698,text,165,651,184,17,4_denoise.png,1024,1430,349,668
11699,text,673,651,56,16,4_denoise.png,1024,1430,729,667
11700,text,41,670,96,15,4_denoise.png,1024,1430,137,685
11701,text,164,668,224,16,4_denoise.png,1024,1430,388,684
11702,text,871,665,47,16,4_denoise.png,1024,1430,918,681
11703,text,43,685,94,15,4_denoise.png,1024,1430,137,700
11704,text,165,684,189,15,4_denoise.png,1024,1430,354,699
11705,text,673,681,56,16,4_denoise.png,1024,1430,729,697
11706,text,871,681,47,14,4_denoise.png,1024,1430,918,695
11707,text,41,701,72,16,4_denoise.png,1024,1430,113,717
11708,text,162,698,372,16,4_denoise.png,1024,1430,534,714
11709,text,671,696,58,17,4_denoise.png,1024,1430,729,713
11710,text,869,693,50,18,4_denoise.png,1024,1430,919,711
11711,text,135,1055,154,20,4_denoise.png,1024,1430,289,1075
11712,text,731,1063,70,20,4_denoise.png,1024,1430,801,1083
11713,text,859,1063,68,20,4_denoise.png,1024,1430,927,1083
11714,text,187,1083,38,18,4_denoise.png,1024,1430,225,1101
11715,text,731,1093,90,20,4_denoise.png,1024,1430,821,1113
11716,text,871,1093,56,20,4_denoise.png,1024,1430,927,1113
11717,text,162,1106,86,18,4_denoise.png,1024,1430,248,1124
11718,text,730,1122,82,24,4_denoise.png,1024,1430,812,1146
11719,text,860,1122,68,24,4_denoise.png,1024,1430,928,1146
11720,text,183,1139,28,16,4_denoise.png,1024,1430,211,1155
11721,text,269,1137,32,18,4_denoise.png,1024,1430,301,1155
11722,text,36,1168,378,24,4_denoise.png,1024,1430,414,1192
11723,text,35,1195,162,16,4_denoise.png,1024,1430,197,1211
11724,text,195,1191,151,21,4_denoise.png,1024,1430,346,1212
11725,text,348,1223,276,18,4_denoise.png,1024,1430,624,1241
11726,text,135,1241,138,20,4_denoise.png,1024,1430,273,1261
11727,text,283,1243,86,18,4_denoise.png,1024,1430,369,1261
11728,text,383,1241,26,18,4_denoise.png,1024,1430,409,1259
11729,text,419,1239,274,20,4_denoise.png,1024,1430,693,1259
11730,text,701,1241,28,16,4_denoise.png,1024,1430,729,1257
11731,text,737,1239,90,18,4_denoise.png,1024,1430,827,1257
11732,text,169,1261,24,20,4_denoise.png,1024,1430,193,1281
11733,text,199,1260,82,19,4_denoise.png,1024,1430,281,1279
11734,text,305,1259,82,18,4_denoise.png,1024,1430,387,1277
11735,text,407,1257,126,20,4_denoise.png,1024,1430,533,1277
11736,text,552,1254,144,24,4_denoise.png,1024,1430,696,1278
11737,text,164,624,44,16,4_denoise.png,1024,1430,208,640
11738,text,586,606,14,14,4_denoise.png,1024,1430,600,620
11739,text,586,620,14,16,4_denoise.png,1024,1430,600,636
11740,text,585,635,14,17,4_denoise.png,1024,1430,599,652
11741,text,586,651,14,15,4_denoise.png,1024,1430,600,666
11742,text,586,667,14,14,4_denoise.png,1024,1430,600,681
11743,text,586,681,14,15,4_denoise.png,1024,1430,600,696
11744,text,586,697,13,17,4_denoise.png,1024,1430,599,714
11745,text,672,667,58,13,4_denoise.png,1024,1430,730,680
11746,text,870,634,50,15,4_denoise.png,1024,1430,920,649
11747,text,870,649,48,16,4_denoise.png,1024,1430,918,665
11748,text,705,1257,159,18,4_denoise.png,1024,1430,864,1275
11749,text,363,93,162,40,4_median.png,1024,1430,525,133
11750,text,198,139,520,27,4_median.png,1024,1430,718,166
11751,text,627,241,132,20,4_median.png,1024,1430,759,261
11752,text,629,259,246,20,4_median.png,1024,1430,875,279
11753,text,625,279,162,20,4_median.png,1024,1430,787,299
11754,text,631,297,106,20,4_median.png,1024,1430,737,317
11755,text,375,393,152,42,4_median.png,1024,1430,527,435
11756,text,41,469,38,16,4_median.png,1024,1430,79,485
11757,text,69,517,106,20,4_median.png,1024,1430,175,537
11758,text,183,517,70,20,4_median.png,1024,1430,253,537
11759,text,311,515,50,20,4_median.png,1024,1430,361,535
11760,text,387,515,68,20,4_median.png,1024,1430,455,535
11761,text,523,513,48,20,4_median.png,1024,1430,571,533
11762,text,709,511,118,20,4_median.png,1024,1430,827,531
11763,text,849,509,68,20,4_median.png,1024,1430,917,529
11764,text,61,577,74,16,4_median.png,1024,1430,135,593
11765,text,299,575,88,18,4_median.png,1024,1430,387,593
11766,text,571,569,30,18,4_median.png,1024,1430,601,587
11767,text,639,571,78,16,4_median.png,1024,1430,717,587
11768,text,737,571,56,18,4_median.png,1024,1430,793,589
11769,text,825,571,84,16,4_median.png,1024,1430,909,587
11770,text,41,607,94,18,4_median.png,1024,1430,135,625
11771,text,165,607,188,16,4_median.png,1024,1430,353,623
11772,text,671,603,58,17,4_median.png,1024,1430,729,620
11773,text,871,605,46,16,4_median.png,1024,1430,917,621
11774,text,43,625,93,15,4_median.png,1024,1430,136,640
11775,text,207,623,177,15,4_median.png,1024,1430,384,638
11776,text,671,620,58,15,4_median.png,1024,1430,729,635
11777,text,871,619,47,16,4_median.png,1024,1430,918,635
11778,text,43,639,92,16,4_median.png,1024,1430,135,655
11779,text,165,638,196,13,4_median.png,1024,1430,361,651
11780,text,673,635,55,16,4_median.png,1024,1430,728,651
11781,text,42,655,95,16,4_median.png,1024,1430,137,671
11782,text,165,651,184,17,4_median.png,1024,1430,349,668
11783,text,673,651,56,16,4_median.png,1024,1430,729,667
11784,text,41,670,96,15,4_median.png,1024,1430,137,685
11785,text,164,668,224,16,4_median.png,1024,1430,388,684
11786,text,871,665,47,16,4_median.png,1024,1430,918,681
11787,text,43,685,94,15,4_median.png,1024,1430,137,700
11788,text,165,684,189,15,4_median.png,1024,1430,354,699
11789,text,673,681,56,16,4_median.png,1024,1430,729,697
11790,text,871,681,47,14,4_median.png,1024,1430,918,695
11791,text,41,701,72,16,4_median.png,1024,1430,113,717
11792,text,162,698,372,16,4_median.png,1024,1430,534,714
11793,text,671,696,58,17,4_median.png,1024,1430,729,713
11794,text,869,693,50,18,4_median.png,1024,1430,919,711
11795,text,135,1055,154,20,4_median.png,1024,1430,289,1075
11796,text,731,1063,70,20,4_median.png,1024,1430,801,1083
11797,text,859,1063,68,20,4_median.png,1024,1430,927,1083
11798,text,187,1083,38,18,4_median.png,1024,1430,225,1101
11799,text,731,1093,90,20,4_median.png,1024,1430,821,1113
11800,text,871,1093,56,20,4_median.png,1024,1430,927,1113
11801,text,162,1106,86,18,4_median.png,1024,1430,248,1124
11802,text,730,1122,82,24,4_median.png,1024,1430,812,1146
11803,text,860,1122,68,24,4_median.png,1024,1430,928,1146
11804,text,183,1139,28,16,4_median.png,1024,1430,211,1155
11805,text,269,1137,32,18,4_median.png,1024,1430,301,1155
11806,text,36,1168,378,24,4_median.png,1024,1430,414,1192
11807,text,35,1195,162,16,4_median.png,1024,1430,197,1211
11808,text,195,1191,151,21,4_median.png,1024,1430,346,1212
11809,text,348,1223,276,18,4_median.png,1024,1430,624,1241
11810,text,135,1241,138,20,4_median.png,1024,1430,273,1261
11811,text,283,1243,86,18,4_median.png,1024,1430,369,1261
11812,text,383,1241,26,18,4_median.png,1024,1430,409,1259
11813,text,419,1239,274,20,4_median.png,1024,1430,693,1259
11814,text,701,1241,28,16,4_median.png,1024,1430,729,1257
11815,text,737,1239,90,18,4_median.png,1024,1430,827,1257
11816,text,169,1261,24,20,4_median.png,1024,1430,193,1281
11817,text,199,1260,82,19,4_median.png,1024,1430,281,1279
11818,text,305,1259,82,18,4_median.png,1024,1430,387,1277
11819,text,407,1257,126,20,4_median.png,1024,1430,533,1277
11820,text,552,1254,144,24,4_median.png,1024,1430,696,1278
11821,text,164,624,44,16,4_median.png,1024,1430,208,640
11822,text,586,606,14,14,4_median.png,1024,1430,600,620
11823,text,586,620,14,16,4_median.png,1024,1430,600,636
11824,text,585,635,14,17,4_median.png,1024,1430,599,652
11825,text,586,651,14,15,4_median.png,1024,1430,600,666
11826,text,586,667,14,14,4_median.png,1024,1430,600,681
11827,text,586,681,14,15,4_median.png,1024,1430,600,696
11828,text,586,697,13,17,4_median.png,1024,1430,599,714
11829,text,672,667,58,13,4_median.png,1024,1430,730,680
11830,text,870,634,50,15,4_median.png,1024,1430,920,649
11831,text,870,649,48,16,4_median.png,1024,1430,918,665
11832,text,705,1257,159,18,4_median.png,1024,1430,864,1275
11833,text,640,57,93,20,5.png,1024,1413,733,77
11834,text,779,57,148,16,5.png,1024,1413,927,73
11835,text,640,74,73,17,5.png,1024,1413,713,91
11836,text,793,71,134,16,5.png,1024,1413,927,87
11837,text,95,57,291,66,5.png,1024,1413,386,123
11838,text,640,87,157,18,5.png,1024,1413,797,105
11839,text,805,87,122,14,5.png,1024,1413,927,101
11840,text,641,103,172,16,5.png,1024,1413,813,119
11841,text,833,101,42,14,5.png,1024,1413,875,115
11842,text,879,101,48,14,5.png,1024,1413,927,115
11843,text,94,122,266,30,5.png,1024,1413,360,152
11844,text,465,157,64,16,5.png,1024,1413,529,173
11845,text,657,157,32,14,5.png,1024,1413,689,171
11846,text,829,155,40,16,5.png,1024,1413,869,171
11847,text,459,185,80,16,5.png,1024,1413,539,201
11848,text,639,185,68,14,5.png,1024,1413,707,199
11849,text,831,183,32,16,5.png,1024,1413,863,199
11850,text,542,220,241,26,5.png,1024,1413,783,246
11851,text,492,246,344,24,5.png,1024,1413,836,270
11852,text,611,267,110,20,5.png,1024,1413,721,287
11853,text,581,285,164,20,5.png,1024,1413,745,305
11854,text,177,319,33,16,5.png,1024,1413,210,335
11855,text,81,357,70,16,5.png,1024,1413,151,373
11856,text,163,357,106,16,5.png,1024,1413,269,373
11857,text,275,351,268,20,5.png,1024,1413,543,371
11858,text,119,409,66,16,5.png,1024,1413,185,425
11859,text,353,407,78,18,5.png,1024,1413,431,425
11860,text,565,405,60,16,5.png,1024,1413,625,421
11861,text,643,405,72,16,5.png,1024,1413,715,421
11862,text,749,403,48,16,5.png,1024,1413,797,419
11863,text,843,403,74,16,5.png,1024,1413,917,419
11864,text,82,435,84,16,5.png,1024,1413,166,451
11865,text,227,431,190,16,5.png,1024,1413,417,447
11866,text,573,433,58,16,5.png,1024,1413,631,449
11867,text,661,431,58,16,5.png,1024,1413,719,447
11868,text,793,431,28,16,5.png,1024,1413,821,447
11869,text,887,429,42,16,5.png,1024,1413,929,445
11870,text,77,1097,185,12,5.png,1024,1413,262,1109
11871,text,569,1121,54,16,5.png,1024,1413,623,1137
11872,text,868,1117,53,16,5.png,1024,1413,921,1133
11873,text,89,1129,36,16,5.png,1024,1413,125,1145
11874,text,161,1129,54,16,5.png,1024,1413,215,1145
11875,text,251,1129,62,14,5.png,1024,1413,313,1143
11876,text,339,1127,84,16,5.png,1024,1413,423,1143
11877,text,569,1149,30,16,5.png,1024,1413,599,1165
11878,text,879,1147,42,16,5.png,1024,1413,921,1163
11879,text,184,1157,51,14,5.png,1024,1413,235,1171
11880,text,285,1155,36,16,5.png,1024,1413,321,1171
11881,text,391,1155,42,14,5.png,1024,1413,433,1169
11882,text,77,1181,270,18,5.png,1024,1413,347,1199
11883,text,569,1179,64,16,5.png,1024,1413,633,1195
11884,text,869,1177,52,14,5.png,1024,1413,921,1191
11885,text,77,1209,210,18,5.png,1024,1413,287,1227
11886,text,69,1291,128,20,5.png,1024,1413,197,1311
11887,text,200,1288,356,24,5.png,1024,1413,556,1312
11888,text,562,1284,113,24,5.png,1024,1413,675,1308
11889,text,246,1306,302,26,5.png,1024,1413,548,1332
11890,text,553,1307,66,18,5.png,1024,1413,619,1325
11891,text,629,1309,72,16,5.png,1024,1413,701,1325
11892,text,711,1309,40,16,5.png,1024,1413,751,1325
11893,text,199,1329,28,18,5.png,1024,1413,227,1347
11894,text,233,1327,114,20,5.png,1024,1413,347,1347
11895,text,353,1327,142,20,5.png,1024,1413,495,1347
11896,text,503,1329,148,16,5.png,1024,1413,651,1345
11897,text,657,1327,140,16,5.png,1024,1413,797,1343
11898,text,711,71,42,15,5.png,1024,1413,753,86
11899,text,82,323,38,17,5.png,1024,1413,120,340
11900,text,96,1156,20,15,5.png,1024,1413,116,1171
11901,text,683,1287,97,19,5.png,1024,1413,780,1306
11902,text,787,1286,142,18,5.png,1024,1413,929,1304
11903,text,385,75,408,44,50.png,1024,1448,793,119
11904,text,430,112,314,26,50.png,1024,1448,744,138
11905,text,381,131,89,28,50.png,1024,1448,470,159
11906,text,476,134,320,26,50.png,1024,1448,796,160
11907,text,438,260,160,26,50.png,1024,1448,598,286
11908,text,436,287,134,28,50.png,1024,1448,570,315
11909,text,438,316,142,26,50.png,1024,1448,580,342
11910,text,438,342,138,26,50.png,1024,1448,576,368
11911,text,440,370,110,24,50.png,1024,1448,550,394
11912,text,665,373,32,18,50.png,1024,1448,697,391
11913,text,142,382,106,24,50.png,1024,1448,248,406
11914,text,257,385,90,20,50.png,1024,1448,347,405
11915,text,148,426,298,24,50.png,1024,1448,446,450
11916,text,574,426,82,24,50.png,1024,1448,656,450
11917,text,666,426,26,24,50.png,1024,1448,692,450
11918,text,710,421,138,28,50.png,1024,1448,848,449
11919,text,178,450,64,24,50.png,1024,1448,242,474
11920,text,254,450,162,26,50.png,1024,1448,416,476
11921,text,786,448,76,24,50.png,1024,1448,862,472
11922,text,305,529,90,18,50.png,1024,1448,395,547
11923,text,593,525,32,20,50.png,1024,1448,625,545
11924,text,677,525,28,20,50.png,1024,1448,705,545
11925,text,771,523,66,20,50.png,1024,1448,837,543
11926,text,116,609,434,25,50.png,1024,1448,550,634
11927,text,652,608,90,24,50.png,1024,1448,742,632
11928,text,770,606,92,24,50.png,1024,1448,862,630
11929,text,114,634,122,24,50.png,1024,1448,236,658
11930,text,114,658,134,26,50.png,1024,1448,248,684
11931,text,666,658,76,24,50.png,1024,1448,742,682
11932,text,784,658,78,24,50.png,1024,1448,862,682
11933,text,112,684,162,29,50.png,1024,1448,274,713
11934,text,664,684,78,24,50.png,1024,1448,742,708
11935,text,782,682,80,26,50.png,1024,1448,862,708
11936,text,112,710,146,24,50.png,1024,1448,258,734
11937,text,665,711,76,20,50.png,1024,1448,741,731
11938,text,782,708,80,24,50.png,1024,1448,862,732
11939,text,374,904,106,24,50.png,1024,1448,480,928
11940,text,774,902,90,26,50.png,1024,1448,864,928
11941,text,367,935,120,20,50.png,1024,1448,487,955
11942,text,774,932,92,24,50.png,1024,1448,866,956
11943,text,364,962,126,24,50.png,1024,1448,490,986
11944,text,774,960,92,24,50.png,1024,1448,866,984
11945,text,136,1032,322,24,50.png,1024,1448,458,1056
11946,text,423,1050,403,26,50.png,1024,1448,826,1076
11947,text,70,1296,134,24,50.png,1024,1448,204,1320
11948,text,216,1299,468,25,50.png,1024,1448,684,1324
11949,text,692,1292,222,26,50.png,1024,1448,914,1318
11950,text,177,1323,115,23,50.png,1024,1448,292,1346
11951,text,77,1346,330,27,50.png,1024,1448,407,1373
11952,text,601,608,14,25,50.png,1024,1448,615,633
11953,text,598,659,20,23,50.png,1024,1448,618,682
11954,text,599,685,17,20,50.png,1024,1448,616,705
11955,text,601,711,15,21,50.png,1024,1448,616,732
11956,text,294,1323,137,21,50.png,1024,1448,431,1344
11957,text,430,1323,182,21,50.png,1024,1448,612,1344
11958,text,617,1318,203,23,50.png,1024,1448,820,1341
11959,text,410,1339,496,31,50.png,1024,1448,906,1370
11960,text,385,75,408,44,50_contrasted.png,1024,1448,793,119
11961,text,430,112,314,26,50_contrasted.png,1024,1448,744,138
11962,text,381,131,89,28,50_contrasted.png,1024,1448,470,159
11963,text,476,134,320,26,50_contrasted.png,1024,1448,796,160
11964,text,438,260,160,26,50_contrasted.png,1024,1448,598,286
11965,text,436,287,134,28,50_contrasted.png,1024,1448,570,315
11966,text,438,316,142,26,50_contrasted.png,1024,1448,580,342
11967,text,438,342,138,26,50_contrasted.png,1024,1448,576,368
11968,text,440,370,110,24,50_contrasted.png,1024,1448,550,394
11969,text,665,373,32,18,50_contrasted.png,1024,1448,697,391
11970,text,142,382,106,24,50_contrasted.png,1024,1448,248,406
11971,text,257,385,90,20,50_contrasted.png,1024,1448,347,405
11972,text,148,426,298,24,50_contrasted.png,1024,1448,446,450
11973,text,574,426,82,24,50_contrasted.png,1024,1448,656,450
11974,text,666,426,26,24,50_contrasted.png,1024,1448,692,450
11975,text,710,421,138,28,50_contrasted.png,1024,1448,848,449
11976,text,178,450,64,24,50_contrasted.png,1024,1448,242,474
11977,text,254,450,162,26,50_contrasted.png,1024,1448,416,476
11978,text,786,448,76,24,50_contrasted.png,1024,1448,862,472
11979,text,305,529,90,18,50_contrasted.png,1024,1448,395,547
11980,text,593,525,32,20,50_contrasted.png,1024,1448,625,545
11981,text,677,525,28,20,50_contrasted.png,1024,1448,705,545
11982,text,771,523,66,20,50_contrasted.png,1024,1448,837,543
11983,text,116,609,434,25,50_contrasted.png,1024,1448,550,634
11984,text,652,608,90,24,50_contrasted.png,1024,1448,742,632
11985,text,770,606,92,24,50_contrasted.png,1024,1448,862,630
11986,text,114,634,122,24,50_contrasted.png,1024,1448,236,658
11987,text,114,658,134,26,50_contrasted.png,1024,1448,248,684
11988,text,666,658,76,24,50_contrasted.png,1024,1448,742,682
11989,text,784,658,78,24,50_contrasted.png,1024,1448,862,682
11990,text,112,684,162,29,50_contrasted.png,1024,1448,274,713
11991,text,664,684,78,24,50_contrasted.png,1024,1448,742,708
11992,text,782,682,80,26,50_contrasted.png,1024,1448,862,708
11993,text,112,710,146,24,50_contrasted.png,1024,1448,258,734
11994,text,665,711,76,20,50_contrasted.png,1024,1448,741,731
11995,text,782,708,80,24,50_contrasted.png,1024,1448,862,732
11996,text,374,904,106,24,50_contrasted.png,1024,1448,480,928
11997,text,774,902,90,26,50_contrasted.png,1024,1448,864,928
11998,text,367,935,120,20,50_contrasted.png,1024,1448,487,955
11999,text,774,932,92,24,50_contrasted.png,1024,1448,866,956
12000,text,364,962,126,24,50_contrasted.png,1024,1448,490,986
12001,text,774,960,92,24,50_contrasted.png,1024,1448,866,984
12002,text,136,1032,322,24,50_contrasted.png,1024,1448,458,1056
12003,text,423,1050,403,26,50_contrasted.png,1024,1448,826,1076
12004,text,70,1296,134,24,50_contrasted.png,1024,1448,204,1320
12005,text,216,1299,468,25,50_contrasted.png,1024,1448,684,1324
12006,text,692,1292,222,26,50_contrasted.png,1024,1448,914,1318
12007,text,177,1323,115,23,50_contrasted.png,1024,1448,292,1346
12008,text,77,1346,330,27,50_contrasted.png,1024,1448,407,1373
12009,text,601,608,14,25,50_contrasted.png,1024,1448,615,633
12010,text,598,659,20,23,50_contrasted.png,1024,1448,618,682
12011,text,599,685,17,20,50_contrasted.png,1024,1448,616,705
12012,text,601,711,15,21,50_contrasted.png,1024,1448,616,732
12013,text,294,1323,137,21,50_contrasted.png,1024,1448,431,1344
12014,text,430,1323,182,21,50_contrasted.png,1024,1448,612,1344
12015,text,617,1318,203,23,50_contrasted.png,1024,1448,820,1341
12016,text,410,1339,496,31,50_contrasted.png,1024,1448,906,1370
12017,text,385,75,408,44,50_denoise.png,1024,1448,793,119
12018,text,430,112,314,26,50_denoise.png,1024,1448,744,138
12019,text,381,131,89,28,50_denoise.png,1024,1448,470,159
12020,text,476,134,320,26,50_denoise.png,1024,1448,796,160
12021,text,438,260,160,26,50_denoise.png,1024,1448,598,286
12022,text,436,287,134,28,50_denoise.png,1024,1448,570,315
12023,text,438,316,142,26,50_denoise.png,1024,1448,580,342
12024,text,438,342,138,26,50_denoise.png,1024,1448,576,368
12025,text,440,370,110,24,50_denoise.png,1024,1448,550,394
12026,text,665,373,32,18,50_denoise.png,1024,1448,697,391
12027,text,142,382,106,24,50_denoise.png,1024,1448,248,406
12028,text,257,385,90,20,50_denoise.png,1024,1448,347,405
12029,text,148,426,298,24,50_denoise.png,1024,1448,446,450
12030,text,574,426,82,24,50_denoise.png,1024,1448,656,450
12031,text,666,426,26,24,50_denoise.png,1024,1448,692,450
12032,text,710,421,138,28,50_denoise.png,1024,1448,848,449
12033,text,178,450,64,24,50_denoise.png,1024,1448,242,474
12034,text,254,450,162,26,50_denoise.png,1024,1448,416,476
12035,text,786,448,76,24,50_denoise.png,1024,1448,862,472
12036,text,305,529,90,18,50_denoise.png,1024,1448,395,547
12037,text,593,525,32,20,50_denoise.png,1024,1448,625,545
12038,text,677,525,28,20,50_denoise.png,1024,1448,705,545
12039,text,771,523,66,20,50_denoise.png,1024,1448,837,543
12040,text,116,609,434,25,50_denoise.png,1024,1448,550,634
12041,text,652,608,90,24,50_denoise.png,1024,1448,742,632
12042,text,770,606,92,24,50_denoise.png,1024,1448,862,630
12043,text,114,634,122,24,50_denoise.png,1024,1448,236,658
12044,text,114,658,134,26,50_denoise.png,1024,1448,248,684
12045,text,666,658,76,24,50_denoise.png,1024,1448,742,682
12046,text,784,658,78,24,50_denoise.png,1024,1448,862,682
12047,text,112,684,162,29,50_denoise.png,1024,1448,274,713
12048,text,664,684,78,24,50_denoise.png,1024,1448,742,708
12049,text,782,682,80,26,50_denoise.png,1024,1448,862,708
12050,text,112,710,146,24,50_denoise.png,1024,1448,258,734
12051,text,665,711,76,20,50_denoise.png,1024,1448,741,731
12052,text,782,708,80,24,50_denoise.png,1024,1448,862,732
12053,text,374,904,106,24,50_denoise.png,1024,1448,480,928
12054,text,774,902,90,26,50_denoise.png,1024,1448,864,928
12055,text,367,935,120,20,50_denoise.png,1024,1448,487,955
12056,text,774,932,92,24,50_denoise.png,1024,1448,866,956
12057,text,364,962,126,24,50_denoise.png,1024,1448,490,986
12058,text,774,960,92,24,50_denoise.png,1024,1448,866,984
12059,text,136,1032,322,24,50_denoise.png,1024,1448,458,1056
12060,text,423,1050,403,26,50_denoise.png,1024,1448,826,1076
12061,text,70,1296,134,24,50_denoise.png,1024,1448,204,1320
12062,text,216,1299,468,25,50_denoise.png,1024,1448,684,1324
12063,text,692,1292,222,26,50_denoise.png,1024,1448,914,1318
12064,text,177,1323,115,23,50_denoise.png,1024,1448,292,1346
12065,text,77,1346,330,27,50_denoise.png,1024,1448,407,1373
12066,text,601,608,14,25,50_denoise.png,1024,1448,615,633
12067,text,598,659,20,23,50_denoise.png,1024,1448,618,682
12068,text,599,685,17,20,50_denoise.png,1024,1448,616,705
12069,text,601,711,15,21,50_denoise.png,1024,1448,616,732
12070,text,294,1323,137,21,50_denoise.png,1024,1448,431,1344
12071,text,430,1323,182,21,50_denoise.png,1024,1448,612,1344
12072,text,617,1318,203,23,50_denoise.png,1024,1448,820,1341
12073,text,410,1339,496,31,50_denoise.png,1024,1448,906,1370
12074,text,385,75,408,44,50_median.png,1024,1448,793,119
12075,text,430,112,314,26,50_median.png,1024,1448,744,138
12076,text,381,131,89,28,50_median.png,1024,1448,470,159
12077,text,476,134,320,26,50_median.png,1024,1448,796,160
12078,text,438,260,160,26,50_median.png,1024,1448,598,286
12079,text,436,287,134,28,50_median.png,1024,1448,570,315
12080,text,438,316,142,26,50_median.png,1024,1448,580,342
12081,text,438,342,138,26,50_median.png,1024,1448,576,368
12082,text,440,370,110,24,50_median.png,1024,1448,550,394
12083,text,665,373,32,18,50_median.png,1024,1448,697,391
12084,text,142,382,106,24,50_median.png,1024,1448,248,406
12085,text,257,385,90,20,50_median.png,1024,1448,347,405
12086,text,148,426,298,24,50_median.png,1024,1448,446,450
12087,text,574,426,82,24,50_median.png,1024,1448,656,450
12088,text,666,426,26,24,50_median.png,1024,1448,692,450
12089,text,710,421,138,28,50_median.png,1024,1448,848,449
12090,text,178,450,64,24,50_median.png,1024,1448,242,474
12091,text,254,450,162,26,50_median.png,1024,1448,416,476
12092,text,786,448,76,24,50_median.png,1024,1448,862,472
12093,text,305,529,90,18,50_median.png,1024,1448,395,547
12094,text,593,525,32,20,50_median.png,1024,1448,625,545
12095,text,677,525,28,20,50_median.png,1024,1448,705,545
12096,text,771,523,66,20,50_median.png,1024,1448,837,543
12097,text,116,609,434,25,50_median.png,1024,1448,550,634
12098,text,652,608,90,24,50_median.png,1024,1448,742,632
12099,text,770,606,92,24,50_median.png,1024,1448,862,630
12100,text,114,634,122,24,50_median.png,1024,1448,236,658
12101,text,114,658,134,26,50_median.png,1024,1448,248,684
12102,text,666,658,76,24,50_median.png,1024,1448,742,682
12103,text,784,658,78,24,50_median.png,1024,1448,862,682
12104,text,112,684,162,29,50_median.png,1024,1448,274,713
12105,text,664,684,78,24,50_median.png,1024,1448,742,708
12106,text,782,682,80,26,50_median.png,1024,1448,862,708
12107,text,112,710,146,24,50_median.png,1024,1448,258,734
12108,text,665,711,76,20,50_median.png,1024,1448,741,731
12109,text,782,708,80,24,50_median.png,1024,1448,862,732
12110,text,374,904,106,24,50_median.png,1024,1448,480,928
12111,text,774,902,90,26,50_median.png,1024,1448,864,928
12112,text,367,935,120,20,50_median.png,1024,1448,487,955
12113,text,774,932,92,24,50_median.png,1024,1448,866,956
12114,text,364,962,126,24,50_median.png,1024,1448,490,986
12115,text,774,960,92,24,50_median.png,1024,1448,866,984
12116,text,136,1032,322,24,50_median.png,1024,1448,458,1056
12117,text,423,1050,403,26,50_median.png,1024,1448,826,1076
12118,text,70,1296,134,24,50_median.png,1024,1448,204,1320
12119,text,216,1299,468,25,50_median.png,1024,1448,684,1324
12120,text,692,1292,222,26,50_median.png,1024,1448,914,1318
12121,text,177,1323,115,23,50_median.png,1024,1448,292,1346
12122,text,77,1346,330,27,50_median.png,1024,1448,407,1373
12123,text,601,608,14,25,50_median.png,1024,1448,615,633
12124,text,598,659,20,23,50_median.png,1024,1448,618,682
12125,text,599,685,17,20,50_median.png,1024,1448,616,705
12126,text,601,711,15,21,50_median.png,1024,1448,616,732
12127,text,294,1323,137,21,50_median.png,1024,1448,431,1344
12128,text,430,1323,182,21,50_median.png,1024,1448,612,1344
12129,text,617,1318,203,23,50_median.png,1024,1448,820,1341
12130,text,410,1339,496,31,50_median.png,1024,1448,906,1370
12131,text,125,99,144,20,51.png,1024,1430,269,119
12132,text,40,146,88,24,51.png,1024,1430,128,170
12133,text,520,146,367,21,51.png,1024,1430,887,167
12134,text,517,165,105,25,51.png,1024,1430,622,190
12135,text,519,189,34,18,51.png,1024,1430,553,207
12136,text,561,189,148,20,51.png,1024,1430,709,209
12137,text,45,201,82,18,51.png,1024,1430,127,219
12138,text,235,201,110,20,51.png,1024,1430,345,221
12139,text,519,207,142,20,51.png,1024,1430,661,227
12140,text,675,211,88,16,51.png,1024,1430,763,227
12141,text,45,229,40,16,51.png,1024,1430,85,245
12142,text,235,227,90,20,51.png,1024,1430,325,247
12143,text,519,225,46,20,51.png,1024,1430,565,245
12144,text,42,248,80,24,51.png,1024,1430,122,272
12145,text,235,253,90,20,51.png,1024,1430,325,273
12146,text,520,246,51,20,51.png,1024,1430,571,266
12147,text,45,279,124,20,51.png,1024,1430,169,299
12148,text,235,279,120,20,51.png,1024,1430,355,299
12149,text,42,332,112,24,51.png,1024,1430,154,356
12150,text,647,337,36,20,51.png,1024,1430,683,357
12151,text,755,339,58,20,51.png,1024,1430,813,359
12152,text,917,339,58,20,51.png,1024,1430,975,359
12153,text,40,364,294,24,51.png,1024,1430,334,388
12154,text,759,373,54,18,51.png,1024,1430,813,391
12155,text,906,371,71,20,51.png,1024,1430,977,391
12156,text,43,387,22,16,51.png,1024,1430,65,403
12157,text,717,461,80,18,51.png,1024,1430,797,479
12158,text,898,461,73,20,51.png,1024,1430,971,481
12159,text,38,472,412,26,51.png,1024,1430,450,498
12160,text,78,497,326,24,51.png,1024,1430,404,521
12161,text,711,489,84,20,51.png,1024,1430,795,509
12162,text,913,491,58,20,51.png,1024,1430,971,511
12163,text,610,516,184,24,51.png,1024,1430,794,540
12164,text,897,519,72,20,51.png,1024,1430,969,539
12165,text,33,575,68,20,51.png,1024,1430,101,595
12166,text,31,609,841,25,51.png,1024,1430,872,634
12167,text,32,642,442,26,51.png,1024,1430,474,668
12168,text,30,674,744,28,51.png,1024,1430,774,702
12169,text,249,1283,146,20,51.png,1024,1430,395,1303
12170,text,401,1286,84,16,51.png,1024,1430,485,1302
12171,text,517,1285,232,20,51.png,1024,1430,749,1305
12172,text,132,1302,267,24,51.png,1024,1430,399,1326
12173,text,207,1323,413,18,51.png,1024,1430,620,1341
12174,text,631,1322,165,24,51.png,1024,1430,796,1346
12175,text,484,1288,34,17,51.png,1024,1430,518,1305
12176,text,666,369,17,21,51.png,1024,1430,683,390
12177,text,402,1302,82,21,51.png,1024,1430,484,1323
12178,text,484,1303,106,19,51.png,1024,1430,590,1322
12179,text,592,1305,95,18,51.png,1024,1430,687,1323
12180,text,691,1304,175,20,51.png,1024,1430,866,1324
12181,text,125,99,144,20,51_contrasted.png,1024,1430,269,119
12182,text,40,146,88,24,51_contrasted.png,1024,1430,128,170
12183,text,520,146,367,21,51_contrasted.png,1024,1430,887,167
12184,text,517,165,105,25,51_contrasted.png,1024,1430,622,190
12185,text,519,189,34,18,51_contrasted.png,1024,1430,553,207
12186,text,561,189,148,20,51_contrasted.png,1024,1430,709,209
12187,text,45,201,82,18,51_contrasted.png,1024,1430,127,219
12188,text,235,201,110,20,51_contrasted.png,1024,1430,345,221
12189,text,519,207,142,20,51_contrasted.png,1024,1430,661,227
12190,text,675,211,88,16,51_contrasted.png,1024,1430,763,227
12191,text,45,229,40,16,51_contrasted.png,1024,1430,85,245
12192,text,235,227,90,20,51_contrasted.png,1024,1430,325,247
12193,text,519,225,46,20,51_contrasted.png,1024,1430,565,245
12194,text,42,248,80,24,51_contrasted.png,1024,1430,122,272
12195,text,235,253,90,20,51_contrasted.png,1024,1430,325,273
12196,text,520,246,51,20,51_contrasted.png,1024,1430,571,266
12197,text,45,279,124,20,51_contrasted.png,1024,1430,169,299
12198,text,235,279,120,20,51_contrasted.png,1024,1430,355,299
12199,text,42,332,112,24,51_contrasted.png,1024,1430,154,356
12200,text,647,337,36,20,51_contrasted.png,1024,1430,683,357
12201,text,755,339,58,20,51_contrasted.png,1024,1430,813,359
12202,text,917,339,58,20,51_contrasted.png,1024,1430,975,359
12203,text,40,364,294,24,51_contrasted.png,1024,1430,334,388
12204,text,759,373,54,18,51_contrasted.png,1024,1430,813,391
12205,text,906,371,71,20,51_contrasted.png,1024,1430,977,391
12206,text,43,387,22,16,51_contrasted.png,1024,1430,65,403
12207,text,717,461,80,18,51_contrasted.png,1024,1430,797,479
12208,text,898,461,73,20,51_contrasted.png,1024,1430,971,481
12209,text,38,472,412,26,51_contrasted.png,1024,1430,450,498
12210,text,78,497,326,24,51_contrasted.png,1024,1430,404,521
12211,text,711,489,84,20,51_contrasted.png,1024,1430,795,509
12212,text,913,491,58,20,51_contrasted.png,1024,1430,971,511
12213,text,610,516,184,24,51_contrasted.png,1024,1430,794,540
12214,text,897,519,72,20,51_contrasted.png,1024,1430,969,539
12215,text,33,575,68,20,51_contrasted.png,1024,1430,101,595
12216,text,31,609,841,25,51_contrasted.png,1024,1430,872,634
12217,text,32,642,442,26,51_contrasted.png,1024,1430,474,668
12218,text,30,674,744,28,51_contrasted.png,1024,1430,774,702
12219,text,249,1283,146,20,51_contrasted.png,1024,1430,395,1303
12220,text,401,1286,84,16,51_contrasted.png,1024,1430,485,1302
12221,text,517,1285,232,20,51_contrasted.png,1024,1430,749,1305
12222,text,132,1302,267,24,51_contrasted.png,1024,1430,399,1326
12223,text,207,1323,413,18,51_contrasted.png,1024,1430,620,1341
12224,text,631,1322,165,24,51_contrasted.png,1024,1430,796,1346
12225,text,484,1288,34,17,51_contrasted.png,1024,1430,518,1305
12226,text,666,369,17,21,51_contrasted.png,1024,1430,683,390
12227,text,402,1302,82,21,51_contrasted.png,1024,1430,484,1323
12228,text,484,1303,106,19,51_contrasted.png,1024,1430,590,1322
12229,text,592,1305,95,18,51_contrasted.png,1024,1430,687,1323
12230,text,691,1304,175,20,51_contrasted.png,1024,1430,866,1324
12231,text,125,99,144,20,51_denoise.png,1024,1430,269,119
12232,text,40,146,88,24,51_denoise.png,1024,1430,128,170
12233,text,520,146,367,21,51_denoise.png,1024,1430,887,167
12234,text,517,165,105,25,51_denoise.png,1024,1430,622,190
12235,text,519,189,34,18,51_denoise.png,1024,1430,553,207
12236,text,561,189,148,20,51_denoise.png,1024,1430,709,209
12237,text,45,201,82,18,51_denoise.png,1024,1430,127,219
12238,text,235,201,110,20,51_denoise.png,1024,1430,345,221
12239,text,519,207,142,20,51_denoise.png,1024,1430,661,227
12240,text,675,211,88,16,51_denoise.png,1024,1430,763,227
12241,text,45,229,40,16,51_denoise.png,1024,1430,85,245
12242,text,235,227,90,20,51_denoise.png,1024,1430,325,247
12243,text,519,225,46,20,51_denoise.png,1024,1430,565,245
12244,text,42,248,80,24,51_denoise.png,1024,1430,122,272
12245,text,235,253,90,20,51_denoise.png,1024,1430,325,273
12246,text,520,246,51,20,51_denoise.png,1024,1430,571,266
12247,text,45,279,124,20,51_denoise.png,1024,1430,169,299
12248,text,235,279,120,20,51_denoise.png,1024,1430,355,299
12249,text,42,332,112,24,51_denoise.png,1024,1430,154,356
12250,text,647,337,36,20,51_denoise.png,1024,1430,683,357
12251,text,755,339,58,20,51_denoise.png,1024,1430,813,359
12252,text,917,339,58,20,51_denoise.png,1024,1430,975,359
12253,text,40,364,294,24,51_denoise.png,1024,1430,334,388
12254,text,759,373,54,18,51_denoise.png,1024,1430,813,391
12255,text,906,371,71,20,51_denoise.png,1024,1430,977,391
12256,text,43,387,22,16,51_denoise.png,1024,1430,65,403
12257,text,717,461,80,18,51_denoise.png,1024,1430,797,479
12258,text,898,461,73,20,51_denoise.png,1024,1430,971,481
12259,text,38,472,412,26,51_denoise.png,1024,1430,450,498
12260,text,78,497,326,24,51_denoise.png,1024,1430,404,521
12261,text,711,489,84,20,51_denoise.png,1024,1430,795,509
12262,text,913,491,58,20,51_denoise.png,1024,1430,971,511
12263,text,610,516,184,24,51_denoise.png,1024,1430,794,540
12264,text,897,519,72,20,51_denoise.png,1024,1430,969,539
12265,text,33,575,68,20,51_denoise.png,1024,1430,101,595
12266,text,31,609,841,25,51_denoise.png,1024,1430,872,634
12267,text,32,642,442,26,51_denoise.png,1024,1430,474,668
12268,text,30,674,744,28,51_denoise.png,1024,1430,774,702
12269,text,249,1283,146,20,51_denoise.png,1024,1430,395,1303
12270,text,401,1286,84,16,51_denoise.png,1024,1430,485,1302
12271,text,517,1285,232,20,51_denoise.png,1024,1430,749,1305
12272,text,132,1302,267,24,51_denoise.png,1024,1430,399,1326
12273,text,207,1323,413,18,51_denoise.png,1024,1430,620,1341
12274,text,631,1322,165,24,51_denoise.png,1024,1430,796,1346
12275,text,484,1288,34,17,51_denoise.png,1024,1430,518,1305
12276,text,666,369,17,21,51_denoise.png,1024,1430,683,390
12277,text,402,1302,82,21,51_denoise.png,1024,1430,484,1323
12278,text,484,1303,106,19,51_denoise.png,1024,1430,590,1322
12279,text,592,1305,95,18,51_denoise.png,1024,1430,687,1323
12280,text,691,1304,175,20,51_denoise.png,1024,1430,866,1324
12281,text,125,99,144,20,51_median.png,1024,1430,269,119
12282,text,40,146,88,24,51_median.png,1024,1430,128,170
12283,text,520,146,367,21,51_median.png,1024,1430,887,167
12284,text,517,165,105,25,51_median.png,1024,1430,622,190
12285,text,519,189,34,18,51_median.png,1024,1430,553,207
12286,text,561,189,148,20,51_median.png,1024,1430,709,209
12287,text,45,201,82,18,51_median.png,1024,1430,127,219
12288,text,235,201,110,20,51_median.png,1024,1430,345,221
12289,text,519,207,142,20,51_median.png,1024,1430,661,227
12290,text,675,211,88,16,51_median.png,1024,1430,763,227
12291,text,45,229,40,16,51_median.png,1024,1430,85,245
12292,text,235,227,90,20,51_median.png,1024,1430,325,247
12293,text,519,225,46,20,51_median.png,1024,1430,565,245
12294,text,42,248,80,24,51_median.png,1024,1430,122,272
12295,text,235,253,90,20,51_median.png,1024,1430,325,273
12296,text,520,246,51,20,51_median.png,1024,1430,571,266
12297,text,45,279,124,20,51_median.png,1024,1430,169,299
12298,text,235,279,120,20,51_median.png,1024,1430,355,299
12299,text,42,332,112,24,51_median.png,1024,1430,154,356
12300,text,647,337,36,20,51_median.png,1024,1430,683,357
12301,text,755,339,58,20,51_median.png,1024,1430,813,359
12302,text,917,339,58,20,51_median.png,1024,1430,975,359
12303,text,40,364,294,24,51_median.png,1024,1430,334,388
12304,text,759,373,54,18,51_median.png,1024,1430,813,391
12305,text,906,371,71,20,51_median.png,1024,1430,977,391
12306,text,43,387,22,16,51_median.png,1024,1430,65,403
12307,text,717,461,80,18,51_median.png,1024,1430,797,479
12308,text,898,461,73,20,51_median.png,1024,1430,971,481
12309,text,38,472,412,26,51_median.png,1024,1430,450,498
12310,text,78,497,326,24,51_median.png,1024,1430,404,521
12311,text,711,489,84,20,51_median.png,1024,1430,795,509
12312,text,913,491,58,20,51_median.png,1024,1430,971,511
12313,text,610,516,184,24,51_median.png,1024,1430,794,540
12314,text,897,519,72,20,51_median.png,1024,1430,969,539
12315,text,33,575,68,20,51_median.png,1024,1430,101,595
12316,text,31,609,841,25,51_median.png,1024,1430,872,634
12317,text,32,642,442,26,51_median.png,1024,1430,474,668
12318,text,30,674,744,28,51_median.png,1024,1430,774,702
12319,text,249,1283,146,20,51_median.png,1024,1430,395,1303
12320,text,401,1286,84,16,51_median.png,1024,1430,485,1302
12321,text,517,1285,232,20,51_median.png,1024,1430,749,1305
12322,text,132,1302,267,24,51_median.png,1024,1430,399,1326
12323,text,207,1323,413,18,51_median.png,1024,1430,620,1341
12324,text,631,1322,165,24,51_median.png,1024,1430,796,1346
12325,text,484,1288,34,17,51_median.png,1024,1430,518,1305
12326,text,666,369,17,21,51_median.png,1024,1430,683,390
12327,text,402,1302,82,21,51_median.png,1024,1430,484,1323
12328,text,484,1303,106,19,51_median.png,1024,1430,590,1322
12329,text,592,1305,95,18,51_median.png,1024,1430,687,1323
12330,text,691,1304,175,20,51_median.png,1024,1430,866,1324
12331,text,68,154,370,32,52.png,1024,1448,438,186
12332,text,727,169,82,20,52.png,1024,1448,809,189
12333,text,632,202,272,26,52.png,1024,1448,904,228
12334,text,681,241,106,20,52.png,1024,1448,787,261
12335,text,795,239,60,20,52.png,1024,1448,855,259
12336,text,674,254,186,26,52.png,1024,1448,860,280
12337,text,697,275,140,20,52.png,1024,1448,837,295
12338,text,171,345,141,26,52.png,1024,1448,312,371
12339,text,382,346,140,24,52.png,1024,1448,522,370
12340,text,87,403,44,20,52.png,1024,1448,131,423
12341,text,243,399,48,20,52.png,1024,1448,291,419
12342,text,425,399,46,20,52.png,1024,1448,471,419
12343,text,68,428,88,24,52.png,1024,1448,156,452
12344,text,381,429,116,20,52.png,1024,1448,497,449
12345,text,91,457,34,20,52.png,1024,1448,125,477
12346,text,298,456,106,24,52.png,1024,1448,404,480
12347,text,586,454,78,24,52.png,1024,1448,664,478
12348,text,703,455,68,20,52.png,1024,1448,771,475
12349,text,817,453,98,20,52.png,1024,1448,915,473
12350,text,42,483,77,20,52.png,1024,1448,119,503
12351,text,217,481,252,20,52.png,1024,1448,469,501
12352,text,738,479,57,20,52.png,1024,1448,795,499
12353,text,884,479,55,18,52.png,1024,1448,939,497
12354,text,518,1142,96,24,52.png,1024,1448,614,1166
12355,text,642,1140,98,24,52.png,1024,1448,740,1164
12356,text,803,1139,104,20,52.png,1024,1448,907,1159
12357,text,569,1169,68,20,52.png,1024,1448,637,1189
12358,text,715,1167,56,20,52.png,1024,1448,771,1187
12359,text,877,1165,68,20,52.png,1024,1448,945,1185
12360,text,510,1200,146,26,52.png,1024,1448,656,1226
12361,text,48,1216,352,30,52.png,1024,1448,400,1246
12362,text,511,1224,389,31,52.png,1024,1448,900,1255
12363,text,56,1250,334,24,52.png,1024,1448,390,1274
12364,text,186,1342,198,24,52.png,1024,1448,384,1366
12365,text,388,1341,323,26,52.png,1024,1448,711,1367
12366,text,76,1362,146,24,52.png,1024,1448,222,1386
12367,text,228,1364,112,24,52.png,1024,1448,340,1388
12368,text,348,1366,148,24,52.png,1024,1448,496,1390
12369,text,723,1367,68,18,52.png,1024,1448,791,1385
12370,text,801,1369,116,18,52.png,1024,1448,917,1387
12371,text,640,1392,228,24,52.png,1024,1448,868,1416
12372,text,622,480,16,20,52.png,1024,1448,638,500
12373,text,509,1366,205,22,52.png,1024,1448,714,1388
12374,text,718,1343,95,22,52.png,1024,1448,813,1365
12375,text,68,154,370,32,52_contrasted.png,1024,1448,438,186
12376,text,727,169,82,20,52_contrasted.png,1024,1448,809,189
12377,text,632,202,272,26,52_contrasted.png,1024,1448,904,228
12378,text,681,241,106,20,52_contrasted.png,1024,1448,787,261
12379,text,795,239,60,20,52_contrasted.png,1024,1448,855,259
12380,text,674,254,186,26,52_contrasted.png,1024,1448,860,280
12381,text,697,275,140,20,52_contrasted.png,1024,1448,837,295
12382,text,171,345,141,26,52_contrasted.png,1024,1448,312,371
12383,text,382,346,140,24,52_contrasted.png,1024,1448,522,370
12384,text,87,403,44,20,52_contrasted.png,1024,1448,131,423
12385,text,243,399,48,20,52_contrasted.png,1024,1448,291,419
12386,text,425,399,46,20,52_contrasted.png,1024,1448,471,419
12387,text,68,428,88,24,52_contrasted.png,1024,1448,156,452
12388,text,381,429,116,20,52_contrasted.png,1024,1448,497,449
12389,text,91,457,34,20,52_contrasted.png,1024,1448,125,477
12390,text,298,456,106,24,52_contrasted.png,1024,1448,404,480
12391,text,586,454,78,24,52_contrasted.png,1024,1448,664,478
12392,text,703,455,68,20,52_contrasted.png,1024,1448,771,475
12393,text,817,453,98,20,52_contrasted.png,1024,1448,915,473
12394,text,42,483,77,20,52_contrasted.png,1024,1448,119,503
12395,text,217,481,252,20,52_contrasted.png,1024,1448,469,501
12396,text,738,479,57,20,52_contrasted.png,1024,1448,795,499
12397,text,884,479,55,18,52_contrasted.png,1024,1448,939,497
12398,text,518,1142,96,24,52_contrasted.png,1024,1448,614,1166
12399,text,642,1140,98,24,52_contrasted.png,1024,1448,740,1164
12400,text,803,1139,104,20,52_contrasted.png,1024,1448,907,1159
12401,text,569,1169,68,20,52_contrasted.png,1024,1448,637,1189
12402,text,715,1167,56,20,52_contrasted.png,1024,1448,771,1187
12403,text,877,1165,68,20,52_contrasted.png,1024,1448,945,1185
12404,text,510,1200,146,26,52_contrasted.png,1024,1448,656,1226
12405,text,48,1216,352,30,52_contrasted.png,1024,1448,400,1246
12406,text,511,1224,389,31,52_contrasted.png,1024,1448,900,1255
12407,text,56,1250,334,24,52_contrasted.png,1024,1448,390,1274
12408,text,186,1342,198,24,52_contrasted.png,1024,1448,384,1366
12409,text,388,1341,323,26,52_contrasted.png,1024,1448,711,1367
12410,text,76,1362,146,24,52_contrasted.png,1024,1448,222,1386
12411,text,228,1364,112,24,52_contrasted.png,1024,1448,340,1388
12412,text,348,1366,148,24,52_contrasted.png,1024,1448,496,1390
12413,text,723,1367,68,18,52_contrasted.png,1024,1448,791,1385
12414,text,801,1369,116,18,52_contrasted.png,1024,1448,917,1387
12415,text,640,1392,228,24,52_contrasted.png,1024,1448,868,1416
12416,text,622,480,16,20,52_contrasted.png,1024,1448,638,500
12417,text,509,1366,205,22,52_contrasted.png,1024,1448,714,1388
12418,text,718,1343,95,22,52_contrasted.png,1024,1448,813,1365
12419,text,68,154,370,32,52_denoise.png,1024,1448,438,186
12420,text,727,169,82,20,52_denoise.png,1024,1448,809,189
12421,text,632,202,272,26,52_denoise.png,1024,1448,904,228
12422,text,681,241,106,20,52_denoise.png,1024,1448,787,261
12423,text,795,239,60,20,52_denoise.png,1024,1448,855,259
12424,text,674,254,186,26,52_denoise.png,1024,1448,860,280
12425,text,697,275,140,20,52_denoise.png,1024,1448,837,295
12426,text,171,345,141,26,52_denoise.png,1024,1448,312,371
12427,text,382,346,140,24,52_denoise.png,1024,1448,522,370
12428,text,87,403,44,20,52_denoise.png,1024,1448,131,423
12429,text,243,399,48,20,52_denoise.png,1024,1448,291,419
12430,text,425,399,46,20,52_denoise.png,1024,1448,471,419
12431,text,68,428,88,24,52_denoise.png,1024,1448,156,452
12432,text,381,429,116,20,52_denoise.png,1024,1448,497,449
12433,text,91,457,34,20,52_denoise.png,1024,1448,125,477
12434,text,298,456,106,24,52_denoise.png,1024,1448,404,480
12435,text,586,454,78,24,52_denoise.png,1024,1448,664,478
12436,text,703,455,68,20,52_denoise.png,1024,1448,771,475
12437,text,817,453,98,20,52_denoise.png,1024,1448,915,473
12438,text,42,483,77,20,52_denoise.png,1024,1448,119,503
12439,text,217,481,252,20,52_denoise.png,1024,1448,469,501
12440,text,738,479,57,20,52_denoise.png,1024,1448,795,499
12441,text,884,479,55,18,52_denoise.png,1024,1448,939,497
12442,text,518,1142,96,24,52_denoise.png,1024,1448,614,1166
12443,text,642,1140,98,24,52_denoise.png,1024,1448,740,1164
12444,text,803,1139,104,20,52_denoise.png,1024,1448,907,1159
12445,text,569,1169,68,20,52_denoise.png,1024,1448,637,1189
12446,text,715,1167,56,20,52_denoise.png,1024,1448,771,1187
12447,text,877,1165,68,20,52_denoise.png,1024,1448,945,1185
12448,text,510,1200,146,26,52_denoise.png,1024,1448,656,1226
12449,text,48,1216,352,30,52_denoise.png,1024,1448,400,1246
12450,text,511,1224,389,31,52_denoise.png,1024,1448,900,1255
12451,text,56,1250,334,24,52_denoise.png,1024,1448,390,1274
12452,text,186,1342,198,24,52_denoise.png,1024,1448,384,1366
12453,text,388,1341,323,26,52_denoise.png,1024,1448,711,1367
12454,text,76,1362,146,24,52_denoise.png,1024,1448,222,1386
12455,text,228,1364,112,24,52_denoise.png,1024,1448,340,1388
12456,text,348,1366,148,24,52_denoise.png,1024,1448,496,1390
12457,text,723,1367,68,18,52_denoise.png,1024,1448,791,1385
12458,text,801,1369,116,18,52_denoise.png,1024,1448,917,1387
12459,text,640,1392,228,24,52_denoise.png,1024,1448,868,1416
12460,text,622,480,16,20,52_denoise.png,1024,1448,638,500
12461,text,509,1366,205,22,52_denoise.png,1024,1448,714,1388
12462,text,718,1343,95,22,52_denoise.png,1024,1448,813,1365
12463,text,68,154,370,32,52_median.png,1024,1448,438,186
12464,text,727,169,82,20,52_median.png,1024,1448,809,189
12465,text,632,202,272,26,52_median.png,1024,1448,904,228
12466,text,681,241,106,20,52_median.png,1024,1448,787,261
12467,text,795,239,60,20,52_median.png,1024,1448,855,259
12468,text,674,254,186,26,52_median.png,1024,1448,860,280
12469,text,697,275,140,20,52_median.png,1024,1448,837,295
12470,text,171,345,141,26,52_median.png,1024,1448,312,371
12471,text,382,346,140,24,52_median.png,1024,1448,522,370
12472,text,87,403,44,20,52_median.png,1024,1448,131,423
12473,text,243,399,48,20,52_median.png,1024,1448,291,419
12474,text,425,399,46,20,52_median.png,1024,1448,471,419
12475,text,68,428,88,24,52_median.png,1024,1448,156,452
12476,text,381,429,116,20,52_median.png,1024,1448,497,449
12477,text,91,457,34,20,52_median.png,1024,1448,125,477
12478,text,298,456,106,24,52_median.png,1024,1448,404,480
12479,text,586,454,78,24,52_median.png,1024,1448,664,478
12480,text,703,455,68,20,52_median.png,1024,1448,771,475
12481,text,817,453,98,20,52_median.png,1024,1448,915,473
12482,text,42,483,77,20,52_median.png,1024,1448,119,503
12483,text,217,481,252,20,52_median.png,1024,1448,469,501
12484,text,738,479,57,20,52_median.png,1024,1448,795,499
12485,text,884,479,55,18,52_median.png,1024,1448,939,497
12486,text,518,1142,96,24,52_median.png,1024,1448,614,1166
12487,text,642,1140,98,24,52_median.png,1024,1448,740,1164
12488,text,803,1139,104,20,52_median.png,1024,1448,907,1159
12489,text,569,1169,68,20,52_median.png,1024,1448,637,1189
12490,text,715,1167,56,20,52_median.png,1024,1448,771,1187
12491,text,877,1165,68,20,52_median.png,1024,1448,945,1185
12492,text,510,1200,146,26,52_median.png,1024,1448,656,1226
12493,text,48,1216,352,30,52_median.png,1024,1448,400,1246
12494,text,511,1224,389,31,52_median.png,1024,1448,900,1255
12495,text,56,1250,334,24,52_median.png,1024,1448,390,1274
12496,text,186,1342,198,24,52_median.png,1024,1448,384,1366
12497,text,388,1341,323,26,52_median.png,1024,1448,711,1367
12498,text,76,1362,146,24,52_median.png,1024,1448,222,1386
12499,text,228,1364,112,24,52_median.png,1024,1448,340,1388
12500,text,348,1366,148,24,52_median.png,1024,1448,496,1390
12501,text,723,1367,68,18,52_median.png,1024,1448,791,1385
12502,text,801,1369,116,18,52_median.png,1024,1448,917,1387
12503,text,640,1392,228,24,52_median.png,1024,1448,868,1416
12504,text,622,480,16,20,52_median.png,1024,1448,638,500
12505,text,509,1366,205,22,52_median.png,1024,1448,714,1388
12506,text,718,1343,95,22,52_median.png,1024,1448,813,1365
12507,text,97,197,296,14,53.png,1024,1448,393,211
12508,text,515,277,108,24,53.png,1024,1448,623,301
12509,text,517,304,234,21,53.png,1024,1448,751,325
12510,text,510,362,54,24,53.png,1024,1448,564,386
12511,text,572,362,122,24,53.png,1024,1448,694,386
12512,text,511,403,48,20,53.png,1024,1448,559,423
12513,text,576,403,128,20,53.png,1024,1448,704,423
12514,text,90,428,122,28,53.png,1024,1448,212,456
12515,text,637,445,32,18,53.png,1024,1448,669,463
12516,text,691,445,122,18,53.png,1024,1448,813,463
12517,text,105,483,74,16,53.png,1024,1448,179,499
12518,text,281,483,34,18,53.png,1024,1448,315,501
12519,text,393,485,78,16,53.png,1024,1448,471,501
12520,text,549,485,172,16,53.png,1024,1448,721,501
12521,text,857,485,30,16,53.png,1024,1448,887,501
12522,text,93,515,34,18,53.png,1024,1448,127,533
12523,text,173,517,70,18,53.png,1024,1448,243,535
12524,text,265,515,80,18,53.png,1024,1448,345,533
12525,text,399,517,82,18,53.png,1024,1448,481,535
12526,text,539,519,156,18,53.png,1024,1448,695,537
12527,text,819,515,110,20,53.png,1024,1448,929,535
12528,text,101,581,80,18,53.png,1024,1448,181,599
12529,text,365,583,80,18,53.png,1024,1448,445,601
12530,text,608,582,59,20,53.png,1024,1448,667,602
12531,text,687,581,58,20,53.png,1024,1448,745,601
12532,text,837,581,80,20,53.png,1024,1448,917,601
12533,text,83,651,44,16,53.png,1024,1448,127,667
12534,text,207,651,264,18,53.png,1024,1448,471,669
12535,text,643,655,26,14,53.png,1024,1448,669,669
12536,text,713,655,58,14,53.png,1024,1448,771,669
12537,text,853,655,58,14,53.png,1024,1448,911,669
12538,text,207,673,376,16,53.png,1024,1448,583,689
12539,text,207,693,29,14,53.png,1024,1448,236,707
12540,text,237,693,105,14,53.png,1024,1448,342,707
12541,text,343,693,90,16,53.png,1024,1448,433,709
12542,text,205,731,28,16,53.png,1024,1448,233,747
12543,text,205,751,218,16,53.png,1024,1448,423,767
12544,text,205,769,126,16,53.png,1024,1448,331,785
12545,text,205,791,82,14,53.png,1024,1448,287,805
12546,text,205,809,92,16,53.png,1024,1448,297,825
12547,text,205,829,164,16,53.png,1024,1448,369,845
12548,text,81,1081,172,18,53.png,1024,1448,253,1099
12549,text,597,1071,58,20,53.png,1024,1448,655,1091
12550,text,871,1073,82,20,53.png,1024,1448,953,1093
12551,text,181,1111,140,18,53.png,1024,1448,321,1129
12552,text,595,1123,80,20,53.png,1024,1448,675,1143
12553,text,883,1121,68,20,53.png,1024,1448,951,1141
12554,text,595,1151,82,20,53.png,1024,1448,677,1171
12555,text,870,1150,82,24,53.png,1024,1448,952,1174
12556,text,73,1191,170,16,53.png,1024,1448,243,1207
12557,text,244,1193,101,14,53.png,1024,1448,345,1207
12558,text,71,1205,344,20,53.png,1024,1448,415,1225
12559,text,592,1220,94,24,53.png,1024,1448,686,1244
12560,text,868,1222,82,24,53.png,1024,1448,950,1246
12561,text,899,1263,46,20,53.png,1024,1448,945,1283
12562,text,451,1289,104,14,53.png,1024,1448,555,1303
12563,text,303,1299,82,14,53.png,1024,1448,385,1313
12564,text,391,1299,56,14,53.png,1024,1448,447,1313
12565,text,454,1301,59,12,53.png,1024,1448,513,1313
12566,text,517,1301,75,14,53.png,1024,1448,592,1315
12567,text,389,1313,138,12,53.png,1024,1448,527,1325
12568,text,531,1313,88,12,53.png,1024,1448,619,1325
12569,text,355,1325,106,14,53.png,1024,1448,461,1339
12570,text,494,1325,97,14,53.png,1024,1448,591,1339
12571,text,594,1328,54,8,53.png,1024,1448,648,1336
12572,text,397,1339,22,12,53.png,1024,1448,419,1351
12573,text,423,1339,184,14,53.png,1024,1448,607,1353
12574,text,343,1349,28,14,53.png,1024,1448,371,1363
12575,text,375,1351,178,12,53.png,1024,1448,553,1363
12576,text,557,1351,34,12,53.png,1024,1448,591,1363
12577,text,597,1351,66,12,53.png,1024,1448,663,1363
12578,text,461,1327,29,10,53.png,1024,1448,490,1337
12579,text,932,581,29,18,53.png,1024,1448,961,599
12580,text,941,653,10,17,53.png,1024,1448,951,670
12581,text,161,1109,14,19,53.png,1024,1448,175,1128
12582,text,596,1300,110,12,53.png,1024,1448,706,1312
12583,text,97,197,296,14,53_contrasted.png,1024,1448,393,211
12584,text,515,277,108,24,53_contrasted.png,1024,1448,623,301
12585,text,517,304,234,21,53_contrasted.png,1024,1448,751,325
12586,text,510,362,54,24,53_contrasted.png,1024,1448,564,386
12587,text,572,362,122,24,53_contrasted.png,1024,1448,694,386
12588,text,511,403,48,20,53_contrasted.png,1024,1448,559,423
12589,text,576,403,128,20,53_contrasted.png,1024,1448,704,423
12590,text,90,428,122,28,53_contrasted.png,1024,1448,212,456
12591,text,637,445,32,18,53_contrasted.png,1024,1448,669,463
12592,text,691,445,122,18,53_contrasted.png,1024,1448,813,463
12593,text,105,483,74,16,53_contrasted.png,1024,1448,179,499
12594,text,281,483,34,18,53_contrasted.png,1024,1448,315,501
12595,text,393,485,78,16,53_contrasted.png,1024,1448,471,501
12596,text,549,485,172,16,53_contrasted.png,1024,1448,721,501
12597,text,857,485,30,16,53_contrasted.png,1024,1448,887,501
12598,text,93,515,34,18,53_contrasted.png,1024,1448,127,533
12599,text,173,517,70,18,53_contrasted.png,1024,1448,243,535
12600,text,265,515,80,18,53_contrasted.png,1024,1448,345,533
12601,text,399,517,82,18,53_contrasted.png,1024,1448,481,535
12602,text,539,519,156,18,53_contrasted.png,1024,1448,695,537
12603,text,819,515,110,20,53_contrasted.png,1024,1448,929,535
12604,text,101,581,80,18,53_contrasted.png,1024,1448,181,599
12605,text,365,583,80,18,53_contrasted.png,1024,1448,445,601
12606,text,608,582,59,20,53_contrasted.png,1024,1448,667,602
12607,text,687,581,58,20,53_contrasted.png,1024,1448,745,601
12608,text,837,581,80,20,53_contrasted.png,1024,1448,917,601
12609,text,83,651,44,16,53_contrasted.png,1024,1448,127,667
12610,text,207,651,264,18,53_contrasted.png,1024,1448,471,669
12611,text,643,655,26,14,53_contrasted.png,1024,1448,669,669
12612,text,713,655,58,14,53_contrasted.png,1024,1448,771,669
12613,text,853,655,58,14,53_contrasted.png,1024,1448,911,669
12614,text,207,673,376,16,53_contrasted.png,1024,1448,583,689
12615,text,207,693,29,14,53_contrasted.png,1024,1448,236,707
12616,text,237,693,105,14,53_contrasted.png,1024,1448,342,707
12617,text,343,693,90,16,53_contrasted.png,1024,1448,433,709
12618,text,205,731,28,16,53_contrasted.png,1024,1448,233,747
12619,text,205,751,218,16,53_contrasted.png,1024,1448,423,767
12620,text,205,769,126,16,53_contrasted.png,1024,1448,331,785
12621,text,205,791,82,14,53_contrasted.png,1024,1448,287,805
12622,text,205,809,92,16,53_contrasted.png,1024,1448,297,825
12623,text,205,829,164,16,53_contrasted.png,1024,1448,369,845
12624,text,81,1081,172,18,53_contrasted.png,1024,1448,253,1099
12625,text,597,1071,58,20,53_contrasted.png,1024,1448,655,1091
12626,text,871,1073,82,20,53_contrasted.png,1024,1448,953,1093
12627,text,181,1111,140,18,53_contrasted.png,1024,1448,321,1129
12628,text,595,1123,80,20,53_contrasted.png,1024,1448,675,1143
12629,text,883,1121,68,20,53_contrasted.png,1024,1448,951,1141
12630,text,595,1151,82,20,53_contrasted.png,1024,1448,677,1171
12631,text,870,1150,82,24,53_contrasted.png,1024,1448,952,1174
12632,text,73,1191,170,16,53_contrasted.png,1024,1448,243,1207
12633,text,244,1193,101,14,53_contrasted.png,1024,1448,345,1207
12634,text,71,1205,344,20,53_contrasted.png,1024,1448,415,1225
12635,text,592,1220,94,24,53_contrasted.png,1024,1448,686,1244
12636,text,868,1222,82,24,53_contrasted.png,1024,1448,950,1246
12637,text,899,1263,46,20,53_contrasted.png,1024,1448,945,1283
12638,text,451,1289,104,14,53_contrasted.png,1024,1448,555,1303
12639,text,303,1299,82,14,53_contrasted.png,1024,1448,385,1313
12640,text,391,1299,56,14,53_contrasted.png,1024,1448,447,1313
12641,text,454,1301,59,12,53_contrasted.png,1024,1448,513,1313
12642,text,517,1301,75,14,53_contrasted.png,1024,1448,592,1315
12643,text,389,1313,138,12,53_contrasted.png,1024,1448,527,1325
12644,text,531,1313,88,12,53_contrasted.png,1024,1448,619,1325
12645,text,355,1325,106,14,53_contrasted.png,1024,1448,461,1339
12646,text,494,1325,97,14,53_contrasted.png,1024,1448,591,1339
12647,text,594,1328,54,8,53_contrasted.png,1024,1448,648,1336
12648,text,397,1339,22,12,53_contrasted.png,1024,1448,419,1351
12649,text,423,1339,184,14,53_contrasted.png,1024,1448,607,1353
12650,text,343,1349,28,14,53_contrasted.png,1024,1448,371,1363
12651,text,375,1351,178,12,53_contrasted.png,1024,1448,553,1363
12652,text,557,1351,34,12,53_contrasted.png,1024,1448,591,1363
12653,text,597,1351,66,12,53_contrasted.png,1024,1448,663,1363
12654,text,461,1327,29,10,53_contrasted.png,1024,1448,490,1337
12655,text,932,581,29,18,53_contrasted.png,1024,1448,961,599
12656,text,941,653,10,17,53_contrasted.png,1024,1448,951,670
12657,text,161,1109,14,19,53_contrasted.png,1024,1448,175,1128
12658,text,596,1300,110,12,53_contrasted.png,1024,1448,706,1312
12659,text,97,197,296,14,53_denoise.png,1024,1448,393,211
12660,text,515,277,108,24,53_denoise.png,1024,1448,623,301
12661,text,517,304,234,21,53_denoise.png,1024,1448,751,325
12662,text,510,362,54,24,53_denoise.png,1024,1448,564,386
12663,text,572,362,122,24,53_denoise.png,1024,1448,694,386
12664,text,511,403,48,20,53_denoise.png,1024,1448,559,423
12665,text,576,403,128,20,53_denoise.png,1024,1448,704,423
12666,text,90,428,122,28,53_denoise.png,1024,1448,212,456
12667,text,637,445,32,18,53_denoise.png,1024,1448,669,463
12668,text,691,445,122,18,53_denoise.png,1024,1448,813,463
12669,text,105,483,74,16,53_denoise.png,1024,1448,179,499
12670,text,281,483,34,18,53_denoise.png,1024,1448,315,501
12671,text,393,485,78,16,53_denoise.png,1024,1448,471,501
12672,text,549,485,172,16,53_denoise.png,1024,1448,721,501
12673,text,857,485,30,16,53_denoise.png,1024,1448,887,501
12674,text,93,515,34,18,53_denoise.png,1024,1448,127,533
12675,text,173,517,70,18,53_denoise.png,1024,1448,243,535
12676,text,265,515,80,18,53_denoise.png,1024,1448,345,533
12677,text,399,517,82,18,53_denoise.png,1024,1448,481,535
12678,text,539,519,156,18,53_denoise.png,1024,1448,695,537
12679,text,819,515,110,20,53_denoise.png,1024,1448,929,535
12680,text,101,581,80,18,53_denoise.png,1024,1448,181,599
12681,text,365,583,80,18,53_denoise.png,1024,1448,445,601
12682,text,608,582,59,20,53_denoise.png,1024,1448,667,602
12683,text,687,581,58,20,53_denoise.png,1024,1448,745,601
12684,text,837,581,80,20,53_denoise.png,1024,1448,917,601
12685,text,83,651,44,16,53_denoise.png,1024,1448,127,667
12686,text,207,651,264,18,53_denoise.png,1024,1448,471,669
12687,text,643,655,26,14,53_denoise.png,1024,1448,669,669
12688,text,713,655,58,14,53_denoise.png,1024,1448,771,669
12689,text,853,655,58,14,53_denoise.png,1024,1448,911,669
12690,text,207,673,376,16,53_denoise.png,1024,1448,583,689
12691,text,207,693,29,14,53_denoise.png,1024,1448,236,707
12692,text,237,693,105,14,53_denoise.png,1024,1448,342,707
12693,text,343,693,90,16,53_denoise.png,1024,1448,433,709
12694,text,205,731,28,16,53_denoise.png,1024,1448,233,747
12695,text,205,751,218,16,53_denoise.png,1024,1448,423,767
12696,text,205,769,126,16,53_denoise.png,1024,1448,331,785
12697,text,205,791,82,14,53_denoise.png,1024,1448,287,805
12698,text,205,809,92,16,53_denoise.png,1024,1448,297,825
12699,text,205,829,164,16,53_denoise.png,1024,1448,369,845
12700,text,81,1081,172,18,53_denoise.png,1024,1448,253,1099
12701,text,597,1071,58,20,53_denoise.png,1024,1448,655,1091
12702,text,871,1073,82,20,53_denoise.png,1024,1448,953,1093
12703,text,181,1111,140,18,53_denoise.png,1024,1448,321,1129
12704,text,595,1123,80,20,53_denoise.png,1024,1448,675,1143
12705,text,883,1121,68,20,53_denoise.png,1024,1448,951,1141
12706,text,595,1151,82,20,53_denoise.png,1024,1448,677,1171
12707,text,870,1150,82,24,53_denoise.png,1024,1448,952,1174
12708,text,73,1191,170,16,53_denoise.png,1024,1448,243,1207
12709,text,244,1193,101,14,53_denoise.png,1024,1448,345,1207
12710,text,71,1205,344,20,53_denoise.png,1024,1448,415,1225
12711,text,592,1220,94,24,53_denoise.png,1024,1448,686,1244
12712,text,868,1222,82,24,53_denoise.png,1024,1448,950,1246
12713,text,899,1263,46,20,53_denoise.png,1024,1448,945,1283
12714,text,451,1289,104,14,53_denoise.png,1024,1448,555,1303
12715,text,303,1299,82,14,53_denoise.png,1024,1448,385,1313
12716,text,391,1299,56,14,53_denoise.png,1024,1448,447,1313
12717,text,454,1301,59,12,53_denoise.png,1024,1448,513,1313
12718,text,517,1301,75,14,53_denoise.png,1024,1448,592,1315
12719,text,389,1313,138,12,53_denoise.png,1024,1448,527,1325
12720,text,531,1313,88,12,53_denoise.png,1024,1448,619,1325
12721,text,355,1325,106,14,53_denoise.png,1024,1448,461,1339
12722,text,494,1325,97,14,53_denoise.png,1024,1448,591,1339
12723,text,594,1328,54,8,53_denoise.png,1024,1448,648,1336
12724,text,397,1339,22,12,53_denoise.png,1024,1448,419,1351
12725,text,423,1339,184,14,53_denoise.png,1024,1448,607,1353
12726,text,343,1349,28,14,53_denoise.png,1024,1448,371,1363
12727,text,375,1351,178,12,53_denoise.png,1024,1448,553,1363
12728,text,557,1351,34,12,53_denoise.png,1024,1448,591,1363
12729,text,597,1351,66,12,53_denoise.png,1024,1448,663,1363
12730,text,461,1327,29,10,53_denoise.png,1024,1448,490,1337
12731,text,932,581,29,18,53_denoise.png,1024,1448,961,599
12732,text,941,653,10,17,53_denoise.png,1024,1448,951,670
12733,text,161,1109,14,19,53_denoise.png,1024,1448,175,1128
12734,text,596,1300,110,12,53_denoise.png,1024,1448,706,1312
12735,text,97,197,296,14,53_median.png,1024,1448,393,211
12736,text,515,277,108,24,53_median.png,1024,1448,623,301
12737,text,517,304,234,21,53_median.png,1024,1448,751,325
12738,text,510,362,54,24,53_median.png,1024,1448,564,386
12739,text,572,362,122,24,53_median.png,1024,1448,694,386
12740,text,511,403,48,20,53_median.png,1024,1448,559,423
12741,text,576,403,128,20,53_median.png,1024,1448,704,423
12742,text,90,428,122,28,53_median.png,1024,1448,212,456
12743,text,637,445,32,18,53_median.png,1024,1448,669,463
12744,text,691,445,122,18,53_median.png,1024,1448,813,463
12745,text,105,483,74,16,53_median.png,1024,1448,179,499
12746,text,281,483,34,18,53_median.png,1024,1448,315,501
12747,text,393,485,78,16,53_median.png,1024,1448,471,501
12748,text,549,485,172,16,53_median.png,1024,1448,721,501
12749,text,857,485,30,16,53_median.png,1024,1448,887,501
12750,text,93,515,34,18,53_median.png,1024,1448,127,533
12751,text,173,517,70,18,53_median.png,1024,1448,243,535
12752,text,265,515,80,18,53_median.png,1024,1448,345,533
12753,text,399,517,82,18,53_median.png,1024,1448,481,535
12754,text,539,519,156,18,53_median.png,1024,1448,695,537
12755,text,819,515,110,20,53_median.png,1024,1448,929,535
12756,text,101,581,80,18,53_median.png,1024,1448,181,599
12757,text,365,583,80,18,53_median.png,1024,1448,445,601
12758,text,608,582,59,20,53_median.png,1024,1448,667,602
12759,text,687,581,58,20,53_median.png,1024,1448,745,601
12760,text,837,581,80,20,53_median.png,1024,1448,917,601
12761,text,83,651,44,16,53_median.png,1024,1448,127,667
12762,text,207,651,264,18,53_median.png,1024,1448,471,669
12763,text,643,655,26,14,53_median.png,1024,1448,669,669
12764,text,713,655,58,14,53_median.png,1024,1448,771,669
12765,text,853,655,58,14,53_median.png,1024,1448,911,669
12766,text,207,673,376,16,53_median.png,1024,1448,583,689
12767,text,207,693,29,14,53_median.png,1024,1448,236,707
12768,text,237,693,105,14,53_median.png,1024,1448,342,707
12769,text,343,693,90,16,53_median.png,1024,1448,433,709
12770,text,205,731,28,16,53_median.png,1024,1448,233,747
12771,text,205,751,218,16,53_median.png,1024,1448,423,767
12772,text,205,769,126,16,53_median.png,1024,1448,331,785
12773,text,205,791,82,14,53_median.png,1024,1448,287,805
12774,text,205,809,92,16,53_median.png,1024,1448,297,825
12775,text,205,829,164,16,53_median.png,1024,1448,369,845
12776,text,81,1081,172,18,53_median.png,1024,1448,253,1099
12777,text,597,1071,58,20,53_median.png,1024,1448,655,1091
12778,text,871,1073,82,20,53_median.png,1024,1448,953,1093
12779,text,181,1111,140,18,53_median.png,1024,1448,321,1129
12780,text,595,1123,80,20,53_median.png,1024,1448,675,1143
12781,text,883,1121,68,20,53_median.png,1024,1448,951,1141
12782,text,595,1151,82,20,53_median.png,1024,1448,677,1171
12783,text,870,1150,82,24,53_median.png,1024,1448,952,1174
12784,text,73,1191,170,16,53_median.png,1024,1448,243,1207
12785,text,244,1193,101,14,53_median.png,1024,1448,345,1207
12786,text,71,1205,344,20,53_median.png,1024,1448,415,1225
12787,text,592,1220,94,24,53_median.png,1024,1448,686,1244
12788,text,868,1222,82,24,53_median.png,1024,1448,950,1246
12789,text,899,1263,46,20,53_median.png,1024,1448,945,1283
12790,text,451,1289,104,14,53_median.png,1024,1448,555,1303
12791,text,303,1299,82,14,53_median.png,1024,1448,385,1313
12792,text,391,1299,56,14,53_median.png,1024,1448,447,1313
12793,text,454,1301,59,12,53_median.png,1024,1448,513,1313
12794,text,517,1301,75,14,53_median.png,1024,1448,592,1315
12795,text,389,1313,138,12,53_median.png,1024,1448,527,1325
12796,text,531,1313,88,12,53_median.png,1024,1448,619,1325
12797,text,355,1325,106,14,53_median.png,1024,1448,461,1339
12798,text,494,1325,97,14,53_median.png,1024,1448,591,1339
12799,text,594,1328,54,8,53_median.png,1024,1448,648,1336
12800,text,397,1339,22,12,53_median.png,1024,1448,419,1351
12801,text,423,1339,184,14,53_median.png,1024,1448,607,1353
12802,text,343,1349,28,14,53_median.png,1024,1448,371,1363
12803,text,375,1351,178,12,53_median.png,1024,1448,553,1363
12804,text,557,1351,34,12,53_median.png,1024,1448,591,1363
12805,text,597,1351,66,12,53_median.png,1024,1448,663,1363
12806,text,461,1327,29,10,53_median.png,1024,1448,490,1337
12807,text,932,581,29,18,53_median.png,1024,1448,961,599
12808,text,941,653,10,17,53_median.png,1024,1448,951,670
12809,text,161,1109,14,19,53_median.png,1024,1448,175,1128
12810,text,596,1300,110,12,53_median.png,1024,1448,706,1312
12811,text,640,57,93,20,5_contrasted.png,1024,1413,733,77
12812,text,779,57,148,16,5_contrasted.png,1024,1413,927,73
12813,text,640,74,73,17,5_contrasted.png,1024,1413,713,91
12814,text,793,71,134,16,5_contrasted.png,1024,1413,927,87
12815,text,95,57,291,66,5_contrasted.png,1024,1413,386,123
12816,text,640,87,157,18,5_contrasted.png,1024,1413,797,105
12817,text,805,87,122,14,5_contrasted.png,1024,1413,927,101
12818,text,641,103,172,16,5_contrasted.png,1024,1413,813,119
12819,text,833,101,42,14,5_contrasted.png,1024,1413,875,115
12820,text,879,101,48,14,5_contrasted.png,1024,1413,927,115
12821,text,94,122,266,30,5_contrasted.png,1024,1413,360,152
12822,text,465,157,64,16,5_contrasted.png,1024,1413,529,173
12823,text,657,157,32,14,5_contrasted.png,1024,1413,689,171
12824,text,829,155,40,16,5_contrasted.png,1024,1413,869,171
12825,text,459,185,80,16,5_contrasted.png,1024,1413,539,201
12826,text,639,185,68,14,5_contrasted.png,1024,1413,707,199
12827,text,831,183,32,16,5_contrasted.png,1024,1413,863,199
12828,text,542,220,241,26,5_contrasted.png,1024,1413,783,246
12829,text,492,246,344,24,5_contrasted.png,1024,1413,836,270
12830,text,611,267,110,20,5_contrasted.png,1024,1413,721,287
12831,text,581,285,164,20,5_contrasted.png,1024,1413,745,305
12832,text,177,319,33,16,5_contrasted.png,1024,1413,210,335
12833,text,81,357,70,16,5_contrasted.png,1024,1413,151,373
12834,text,163,357,106,16,5_contrasted.png,1024,1413,269,373
12835,text,275,351,268,20,5_contrasted.png,1024,1413,543,371
12836,text,119,409,66,16,5_contrasted.png,1024,1413,185,425
12837,text,353,407,78,18,5_contrasted.png,1024,1413,431,425
12838,text,565,405,60,16,5_contrasted.png,1024,1413,625,421
12839,text,643,405,72,16,5_contrasted.png,1024,1413,715,421
12840,text,749,403,48,16,5_contrasted.png,1024,1413,797,419
12841,text,843,403,74,16,5_contrasted.png,1024,1413,917,419
12842,text,82,435,84,16,5_contrasted.png,1024,1413,166,451
12843,text,227,431,190,16,5_contrasted.png,1024,1413,417,447
12844,text,573,433,58,16,5_contrasted.png,1024,1413,631,449
12845,text,661,431,58,16,5_contrasted.png,1024,1413,719,447
12846,text,793,431,28,16,5_contrasted.png,1024,1413,821,447
12847,text,887,429,42,16,5_contrasted.png,1024,1413,929,445
12848,text,77,1097,185,12,5_contrasted.png,1024,1413,262,1109
12849,text,569,1121,54,16,5_contrasted.png,1024,1413,623,1137
12850,text,868,1117,53,16,5_contrasted.png,1024,1413,921,1133
12851,text,89,1129,36,16,5_contrasted.png,1024,1413,125,1145
12852,text,161,1129,54,16,5_contrasted.png,1024,1413,215,1145
12853,text,251,1129,62,14,5_contrasted.png,1024,1413,313,1143
12854,text,339,1127,84,16,5_contrasted.png,1024,1413,423,1143
12855,text,569,1149,30,16,5_contrasted.png,1024,1413,599,1165
12856,text,879,1147,42,16,5_contrasted.png,1024,1413,921,1163
12857,text,184,1157,51,14,5_contrasted.png,1024,1413,235,1171
12858,text,285,1155,36,16,5_contrasted.png,1024,1413,321,1171
12859,text,391,1155,42,14,5_contrasted.png,1024,1413,433,1169
12860,text,77,1181,270,18,5_contrasted.png,1024,1413,347,1199
12861,text,569,1179,64,16,5_contrasted.png,1024,1413,633,1195
12862,text,869,1177,52,14,5_contrasted.png,1024,1413,921,1191
12863,text,77,1209,210,18,5_contrasted.png,1024,1413,287,1227
12864,text,69,1291,128,20,5_contrasted.png,1024,1413,197,1311
12865,text,200,1288,356,24,5_contrasted.png,1024,1413,556,1312
12866,text,562,1284,113,24,5_contrasted.png,1024,1413,675,1308
12867,text,246,1306,302,26,5_contrasted.png,1024,1413,548,1332
12868,text,553,1307,66,18,5_contrasted.png,1024,1413,619,1325
12869,text,629,1309,72,16,5_contrasted.png,1024,1413,701,1325
12870,text,711,1309,40,16,5_contrasted.png,1024,1413,751,1325
12871,text,199,1329,28,18,5_contrasted.png,1024,1413,227,1347
12872,text,233,1327,114,20,5_contrasted.png,1024,1413,347,1347
12873,text,353,1327,142,20,5_contrasted.png,1024,1413,495,1347
12874,text,503,1329,148,16,5_contrasted.png,1024,1413,651,1345
12875,text,657,1327,140,16,5_contrasted.png,1024,1413,797,1343
12876,text,711,71,42,15,5_contrasted.png,1024,1413,753,86
12877,text,82,323,38,17,5_contrasted.png,1024,1413,120,340
12878,text,96,1156,20,15,5_contrasted.png,1024,1413,116,1171
12879,text,683,1287,97,19,5_contrasted.png,1024,1413,780,1306
12880,text,787,1286,142,18,5_contrasted.png,1024,1413,929,1304
12881,text,640,57,93,20,5_denoise.png,1024,1413,733,77
12882,text,779,57,148,16,5_denoise.png,1024,1413,927,73
12883,text,640,74,73,17,5_denoise.png,1024,1413,713,91
12884,text,793,71,134,16,5_denoise.png,1024,1413,927,87
12885,text,95,57,291,66,5_denoise.png,1024,1413,386,123
12886,text,640,87,157,18,5_denoise.png,1024,1413,797,105
12887,text,805,87,122,14,5_denoise.png,1024,1413,927,101
12888,text,641,103,172,16,5_denoise.png,1024,1413,813,119
12889,text,833,101,42,14,5_denoise.png,1024,1413,875,115
12890,text,879,101,48,14,5_denoise.png,1024,1413,927,115
12891,text,94,122,266,30,5_denoise.png,1024,1413,360,152
12892,text,465,157,64,16,5_denoise.png,1024,1413,529,173
12893,text,657,157,32,14,5_denoise.png,1024,1413,689,171
12894,text,829,155,40,16,5_denoise.png,1024,1413,869,171
12895,text,459,185,80,16,5_denoise.png,1024,1413,539,201
12896,text,639,185,68,14,5_denoise.png,1024,1413,707,199
12897,text,831,183,32,16,5_denoise.png,1024,1413,863,199
12898,text,542,220,241,26,5_denoise.png,1024,1413,783,246
12899,text,492,246,344,24,5_denoise.png,1024,1413,836,270
12900,text,611,267,110,20,5_denoise.png,1024,1413,721,287
12901,text,581,285,164,20,5_denoise.png,1024,1413,745,305
12902,text,177,319,33,16,5_denoise.png,1024,1413,210,335
12903,text,81,357,70,16,5_denoise.png,1024,1413,151,373
12904,text,163,357,106,16,5_denoise.png,1024,1413,269,373
12905,text,275,351,268,20,5_denoise.png,1024,1413,543,371
12906,text,119,409,66,16,5_denoise.png,1024,1413,185,425
12907,text,353,407,78,18,5_denoise.png,1024,1413,431,425
12908,text,565,405,60,16,5_denoise.png,1024,1413,625,421
12909,text,643,405,72,16,5_denoise.png,1024,1413,715,421
12910,text,749,403,48,16,5_denoise.png,1024,1413,797,419
12911,text,843,403,74,16,5_denoise.png,1024,1413,917,419
12912,text,82,435,84,16,5_denoise.png,1024,1413,166,451
12913,text,227,431,190,16,5_denoise.png,1024,1413,417,447
12914,text,573,433,58,16,5_denoise.png,1024,1413,631,449
12915,text,661,431,58,16,5_denoise.png,1024,1413,719,447
12916,text,793,431,28,16,5_denoise.png,1024,1413,821,447
12917,text,887,429,42,16,5_denoise.png,1024,1413,929,445
12918,text,77,1097,185,12,5_denoise.png,1024,1413,262,1109
12919,text,569,1121,54,16,5_denoise.png,1024,1413,623,1137
12920,text,868,1117,53,16,5_denoise.png,1024,1413,921,1133
12921,text,89,1129,36,16,5_denoise.png,1024,1413,125,1145
12922,text,161,1129,54,16,5_denoise.png,1024,1413,215,1145
12923,text,251,1129,62,14,5_denoise.png,1024,1413,313,1143
12924,text,339,1127,84,16,5_denoise.png,1024,1413,423,1143
12925,text,569,1149,30,16,5_denoise.png,1024,1413,599,1165
12926,text,879,1147,42,16,5_denoise.png,1024,1413,921,1163
12927,text,184,1157,51,14,5_denoise.png,1024,1413,235,1171
12928,text,285,1155,36,16,5_denoise.png,1024,1413,321,1171
12929,text,391,1155,42,14,5_denoise.png,1024,1413,433,1169
12930,text,77,1181,270,18,5_denoise.png,1024,1413,347,1199
12931,text,569,1179,64,16,5_denoise.png,1024,1413,633,1195
12932,text,869,1177,52,14,5_denoise.png,1024,1413,921,1191
12933,text,77,1209,210,18,5_denoise.png,1024,1413,287,1227
12934,text,69,1291,128,20,5_denoise.png,1024,1413,197,1311
12935,text,200,1288,356,24,5_denoise.png,1024,1413,556,1312
12936,text,562,1284,113,24,5_denoise.png,1024,1413,675,1308
12937,text,246,1306,302,26,5_denoise.png,1024,1413,548,1332
12938,text,553,1307,66,18,5_denoise.png,1024,1413,619,1325
12939,text,629,1309,72,16,5_denoise.png,1024,1413,701,1325
12940,text,711,1309,40,16,5_denoise.png,1024,1413,751,1325
12941,text,199,1329,28,18,5_denoise.png,1024,1413,227,1347
12942,text,233,1327,114,20,5_denoise.png,1024,1413,347,1347
12943,text,353,1327,142,20,5_denoise.png,1024,1413,495,1347
12944,text,503,1329,148,16,5_denoise.png,1024,1413,651,1345
12945,text,657,1327,140,16,5_denoise.png,1024,1413,797,1343
12946,text,711,71,42,15,5_denoise.png,1024,1413,753,86
12947,text,82,323,38,17,5_denoise.png,1024,1413,120,340
12948,text,96,1156,20,15,5_denoise.png,1024,1413,116,1171
12949,text,683,1287,97,19,5_denoise.png,1024,1413,780,1306
12950,text,787,1286,142,18,5_denoise.png,1024,1413,929,1304
12951,text,640,57,93,20,5_median.png,1024,1413,733,77
12952,text,779,57,148,16,5_median.png,1024,1413,927,73
12953,text,640,74,73,17,5_median.png,1024,1413,713,91
12954,text,793,71,134,16,5_median.png,1024,1413,927,87
12955,text,95,57,291,66,5_median.png,1024,1413,386,123
12956,text,640,87,157,18,5_median.png,1024,1413,797,105
12957,text,805,87,122,14,5_median.png,1024,1413,927,101
12958,text,641,103,172,16,5_median.png,1024,1413,813,119
12959,text,833,101,42,14,5_median.png,1024,1413,875,115
12960,text,879,101,48,14,5_median.png,1024,1413,927,115
12961,text,94,122,266,30,5_median.png,1024,1413,360,152
12962,text,465,157,64,16,5_median.png,1024,1413,529,173
12963,text,657,157,32,14,5_median.png,1024,1413,689,171
12964,text,829,155,40,16,5_median.png,1024,1413,869,171
12965,text,459,185,80,16,5_median.png,1024,1413,539,201
12966,text,639,185,68,14,5_median.png,1024,1413,707,199
12967,text,831,183,32,16,5_median.png,1024,1413,863,199
12968,text,542,220,241,26,5_median.png,1024,1413,783,246
12969,text,492,246,344,24,5_median.png,1024,1413,836,270
12970,text,611,267,110,20,5_median.png,1024,1413,721,287
12971,text,581,285,164,20,5_median.png,1024,1413,745,305
12972,text,177,319,33,16,5_median.png,1024,1413,210,335
12973,text,81,357,70,16,5_median.png,1024,1413,151,373
12974,text,163,357,106,16,5_median.png,1024,1413,269,373
12975,text,275,351,268,20,5_median.png,1024,1413,543,371
12976,text,119,409,66,16,5_median.png,1024,1413,185,425
12977,text,353,407,78,18,5_median.png,1024,1413,431,425
12978,text,565,405,60,16,5_median.png,1024,1413,625,421
12979,text,643,405,72,16,5_median.png,1024,1413,715,421
12980,text,749,403,48,16,5_median.png,1024,1413,797,419
12981,text,843,403,74,16,5_median.png,1024,1413,917,419
12982,text,82,435,84,16,5_median.png,1024,1413,166,451
12983,text,227,431,190,16,5_median.png,1024,1413,417,447
12984,text,573,433,58,16,5_median.png,1024,1413,631,449
12985,text,661,431,58,16,5_median.png,1024,1413,719,447
12986,text,793,431,28,16,5_median.png,1024,1413,821,447
12987,text,887,429,42,16,5_median.png,1024,1413,929,445
12988,text,77,1097,185,12,5_median.png,1024,1413,262,1109
12989,text,569,1121,54,16,5_median.png,1024,1413,623,1137
12990,text,868,1117,53,16,5_median.png,1024,1413,921,1133
12991,text,89,1129,36,16,5_median.png,1024,1413,125,1145
12992,text,161,1129,54,16,5_median.png,1024,1413,215,1145
12993,text,251,1129,62,14,5_median.png,1024,1413,313,1143
12994,text,339,1127,84,16,5_median.png,1024,1413,423,1143
12995,text,569,1149,30,16,5_median.png,1024,1413,599,1165
12996,text,879,1147,42,16,5_median.png,1024,1413,921,1163
12997,text,184,1157,51,14,5_median.png,1024,1413,235,1171
12998,text,285,1155,36,16,5_median.png,1024,1413,321,1171
12999,text,391,1155,42,14,5_median.png,1024,1413,433,1169
13000,text,77,1181,270,18,5_median.png,1024,1413,347,1199
13001,text,569,1179,64,16,5_median.png,1024,1413,633,1195
13002,text,869,1177,52,14,5_median.png,1024,1413,921,1191
13003,text,77,1209,210,18,5_median.png,1024,1413,287,1227
13004,text,69,1291,128,20,5_median.png,1024,1413,197,1311
13005,text,200,1288,356,24,5_median.png,1024,1413,556,1312
13006,text,562,1284,113,24,5_median.png,1024,1413,675,1308
13007,text,246,1306,302,26,5_median.png,1024,1413,548,1332
13008,text,553,1307,66,18,5_median.png,1024,1413,619,1325
13009,text,629,1309,72,16,5_median.png,1024,1413,701,1325
13010,text,711,1309,40,16,5_median.png,1024,1413,751,1325
13011,text,199,1329,28,18,5_median.png,1024,1413,227,1347
13012,text,233,1327,114,20,5_median.png,1024,1413,347,1347
13013,text,353,1327,142,20,5_median.png,1024,1413,495,1347
13014,text,503,1329,148,16,5_median.png,1024,1413,651,1345
13015,text,657,1327,140,16,5_median.png,1024,1413,797,1343
13016,text,711,71,42,15,5_median.png,1024,1413,753,86
13017,text,82,323,38,17,5_median.png,1024,1413,120,340
13018,text,96,1156,20,15,5_median.png,1024,1413,116,1171
13019,text,683,1287,97,19,5_median.png,1024,1413,780,1306
13020,text,787,1286,142,18,5_median.png,1024,1413,929,1304
